User,Votes,Up,Down,Comments,Posts,DateUser,Affiliation
tomo,2348,2348,0,0,0,07/05/2012,NTHU
Reiko,1902,1902,0,21,1,11/13/2011,AIfA-Cosmo
Franz Bauer,1384,1382,2,0,0,03/26/2011,PUC-Institute of Astrophysics
Brian Siana,1361,1361,0,0,0,08/18/2010,UCR
Andrew Zentner,1214,1212,2,0,3,02/15/2011,U. Pittsburgh
hcferguson,1184,1184,0,0,0,09/12/2011,STScI/JHU
kwillett,1173,1169,4,1,0,11/05/2010,UMN
Evan Kirby,1119,1119,0,0,2,06/24/2010,Caltech
vdbosch,1068,1057,11,0,0,01/27/2012,Yale
Johan,942,942,0,14,0,07/01/2010,DARK
Joo Heon Yoon,888,887,1,0,0,09/16/2010,UCSB
Cara Battersby,870,870,0,1,0,11/05/2010,CU Boulder
molly,864,864,0,0,0,09/28/2011,STScI/JHU
chunly,826,825,1,0,0,04/28/2011,NASA GSFC Extragalactic
pela,806,804,2,0,0,07/07/2010,DARK
GL,797,796,1,0,0,07/01/2010,Weizmann Institute of Science
James Guillochon,779,777,2,45,114,07/25/2009,Harvard ITC
jlu,765,765,0,1,1,06/27/2010,"IfA, University of Hawaii"
shooby,745,745,0,0,0,04/09/2011,UCR
Geier,701,661,40,4,0,07/01/2010,DARK
Shami Chatterjee,697,696,1,3,16,07/30/2012,Cornell
marianojavierdeleon,688,688,0,0,0,04/15/2012,IATE
anahita alavi,654,654,0,0,0,04/09/2011,UCR
azirm,650,639,11,0,0,07/01/2010,DARK
steen h,643,642,1,0,0,07/01/2010,DARK
mtsargent,639,639,0,0,0,01/10/2011,"U. of Sussex, Astronomy Centre"
tpuzia,629,628,1,1,0,01/30/2011,PUC-Institute of Astrophysics
KP,622,609,13,0,0,07/01/2010,DARK
VarunBhalerao,592,591,1,0,0,10/19/2011,IUCAA
Nathan Goldbaum,577,577,0,19,23,08/30/2009,UCSC
jmackey,577,577,0,0,0,08/12/2010,AIfA
marceau,571,571,0,0,0,01/20/2011,LAM
edaddi,565,565,0,0,0,12/02/2010,CEA Saclay
hdole,559,559,0,0,0,04/01/2011,IAS Orsay
Cristobal,509,509,0,0,0,03/27/2011,Leiden
oshaughn,501,501,0,2,12,11/11/2010,RIT-CCRG
clsj,491,491,0,0,0,01/17/2011,CEFCA
lidia,490,490,0,1,0,12/10/2010,LAM
cschimd,483,483,0,0,0,03/23/2011,LAM
Laura Lopez,481,479,2,6,2,08/14/2009,Harvard ITC
annag,469,469,0,0,0,01/31/2011,Osservatorio Astrofisico di Arcetri - Extragalactic
jcuadra,464,464,0,0,0,03/27/2011,PUC-Institute of Astrophysics
pnair,464,464,0,0,0,01/25/2012,STScI/JHU
yuan,463,462,1,0,0,09/14/2010,Columbia
szibetti,461,456,5,1,0,10/12/2010,Osservatorio Astrofisico di Arcetri - Extragalactic
martin,453,453,0,0,0,08/22/2013,RSAA-ANU
sutirtha,445,444,1,1,0,10/23/2012,AIfA
Mariana Lazarova,434,434,0,0,0,04/05/2011,UCR
Katie Jameson,431,431,0,0,2,10/02/2012,University of Maryland
J.D.Bradford,430,429,1,1,0,10/05/2012,Yale
mpannella,429,429,0,0,0,12/02/2010,CEA Saclay
Marcel Haas,424,423,1,0,1,12/15/2010,Rutgers
Xing Lu,406,406,0,1,0,11/20/2012,Nanjing University
Erik Tollerud,405,404,1,0,1,09/05/2012,Yale
Bo Milvang-Jensen,397,397,0,1,0,07/05/2010,DARK
adegr001,384,384,0,0,0,04/19/2011,UCR
jselsing,382,382,0,0,0,05/07/2013,DARK
Professor X,376,376,0,0,0,09/04/2009,UCSC
SViaene,375,375,0,2,0,11/22/2012,Ghent University
wojtak,360,360,0,0,0,09/06/2010,DARK
danichao,360,360,0,0,0,04/08/2014,NTHU
Alexander Mendez,358,358,0,0,0,11/23/2011,Johns Hopkins
Teddy,355,344,11,0,0,07/01/2010,DARK
duncan.campbell,350,350,0,0,0,01/30/2012,Yale-LSS
Mike Cooper,349,349,0,0,0,01/23/2013,UCI
Davide Lena,340,340,0,1,0,09/03/2012,RIT
khiner,327,327,0,0,0,04/07/2011,"U. de Concepcion: Planetary, Stellar, Galactic, Extragalactic papers"
johannes,327,327,0,0,0,08/31/2011,DARK
anilseth,320,320,0,0,0,12/10/2013,University of Utah
Mark Krumholz,319,318,1,3,0,08/12/2009,UCSC
mssgill,315,314,1,21,0,09/07/2012,Stanford
bechtol,314,314,0,1,6,08/18/2012,Chicago-KICP
Edo,312,312,0,0,0,11/29/2011,AIfA-Cosmo
Irene Shivaei,310,310,0,0,0,03/08/2012,UCR
mizuno,306,306,0,0,0,02/20/2014,Goethe University-ITP
Simon Mutch,302,302,0,0,0,02/16/2011,University of Melbourne
Martin Sparre,299,299,0,0,0,07/09/2010,DARK
shc,296,296,0,0,3,08/10/2011,ASU Astro
Pierre North,291,291,0,0,0,01/12/2012,EPFL - UniGe
chentao yang,289,289,0,1,5,02/18/2011,IAS Orsay
Ryosuke Goto,289,289,0,0,0,04/10/2014,University of Tokyo
jnantais,287,287,0,0,0,04/03/2013,"U. de Concepcion: Planetary, Stellar, Galactic, Extragalactic papers"
GRod,276,270,6,0,0,01/29/2013,INAF-OAR
allison,276,273,3,0,0,08/24/2010,DARK
andrews,271,269,2,0,1,09/07/2010,Columbia
lundmb,271,271,0,0,0,09/10/2012,Vanderbilt
jnburchett,270,270,0,0,0,12/17/2013,UMass Amherst
Johan Richard,267,266,1,0,0,09/03/2010,CRAL
Anna Cibinel,263,263,0,0,0,06/24/2011,"U. of Sussex, Astronomy Centre"
jwardlow,261,261,0,0,0,02/05/2013,DARK
dmalesani,253,252,1,0,0,07/01/2010,DARK
mbaes,252,252,0,0,0,11/23/2012,Ghent University
bellm,250,250,0,0,0,04/03/2012,unaffiliated
Ciska Kemper,247,247,0,1,4,01/27/2011,ASIAA
kfinlator,247,247,0,0,0,02/10/2013,DARK
rjw,246,246,0,0,0,09/27/2012,Carnegie
David_Nataf,245,245,0,0,0,08/26/2013,RSAA-ANU
Y. Cai,244,244,0,0,0,05/23/2011,Durham University
gsnyder,240,240,0,0,0,08/14/2012,STScI/JHU
awetzel,238,238,0,0,0,01/26/2012,Carnegie
aphearin,237,237,0,0,1,11/02/2011,Yale
Arthur,237,237,0,0,0,09/18/2012,Yale
mkmprescott,236,236,0,0,0,02/20/2012,DARK
Marco Castellani,234,220,14,6,0,01/24/2013,INAF-OAR
jschwab,233,233,0,0,0,08/25/2010,UCB
koayjy,233,233,0,0,0,10/18/2013,DARK
zhengz,230,230,0,0,5,09/05/2013,University of Utah
tumlinson,228,228,0,1,0,08/22/2011,STScI/JHU
drapetti,226,226,0,0,0,10/19/2010,DARK
olehost,226,226,0,0,0,10/02/2012,DARK
fschneid,223,223,0,0,0,10/22/2012,AIfA
Adam Ginsburg,221,218,3,5,2,11/04/2010,CU Boulder
rskibba,220,220,0,0,0,09/30/2013,UCSD
kuanghan,219,219,0,0,0,09/14/2011,STScI/JHU
ryano,217,216,1,1,4,09/14/2010,UCB
rleiton,214,214,0,0,0,01/11/2011,"U. de Concepcion: Planetary, Stellar, Galactic, Extragalactic papers"
jillian,213,212,1,0,0,09/10/2012,Vanderbilt
amedling,213,213,0,0,2,10/09/2009,RSAA-ANU
RussellRyan,212,212,0,0,0,09/16/2011,STScI/JHU
eliot,207,207,0,0,2,08/25/2010,UCB
badenes,207,207,0,0,0,09/29/2011,U. Pittsburgh
eugvas,204,204,0,1,0,09/05/2012,RIT
courbin,203,201,2,1,0,02/10/2012,EPFL - UniGe
Signe,202,202,0,0,0,08/09/2010,UQ
DrMudlark,200,200,0,1,0,09/18/2013,"U. of Sussex, Astronomy Centre"
JRM,199,199,0,1,0,12/03/2010,Durham University
Kenneth Wong,199,199,0,0,0,04/17/2011,ASIAA
profsuvi,198,198,0,0,0,10/08/2012,University of Maryland
Rich Bielby,193,192,1,0,0,01/26/2011,Durham University
dorazio,193,193,0,0,0,09/09/2010,Columbia
Aleks Diamond-Stanic,193,193,0,0,0,09/24/2013,UW Madison
dtsang,192,192,0,0,5,09/28/2010,McGill
knicole,192,192,0,0,0,02/04/2014,Lehigh University
Mathieu Servillat,190,190,0,0,1,10/25/2010,CEA Saclay High Energy
Katie Grasha,189,189,0,0,0,01/20/2014,UMass Amherst
Michele,188,188,0,0,4,09/09/2009,Durham University
Laura Blecha,187,187,0,0,0,10/15/2012,University of Maryland
Matthew Stevenson,186,186,0,0,0,09/23/2010,Caltech
janieb,186,186,0,0,0,11/07/2011,University of Vienna
Rene Breton,185,184,1,3,0,02/01/2011,University of Southampton
hfrancke,182,182,0,0,0,04/13/2011,PUC-Institute of Astrophysics
calzetti,179,179,0,1,0,01/22/2014,UMass Amherst
tgreve,178,175,3,0,0,07/01/2010,UCL Extragalactic Journal Club
gully,178,178,0,0,1,07/18/2011,UT Austin
eford,176,176,0,6,0,10/28/2011,Penn State
Joel Leja,174,174,0,0,0,02/01/2012,Yale
Travis,173,173,0,0,0,02/17/2011,U. Pittsburgh
zkbt,172,172,0,0,0,09/11/2013,MIT
mmcquinn,171,170,1,0,1,08/25/2010,University of Washington
jpiscionere,171,171,0,0,0,08/07/2012,Vanderbilt
fbian,170,170,0,1,0,06/10/2011,RSAA-ANU
mbusha,168,168,0,0,0,05/28/2012,Stanford
dccollins,167,167,0,0,0,05/21/2014,FSU Astrophysics
SBonoli,165,165,0,0,0,05/25/2012,CEFCA
aspacek,165,165,0,0,0,09/28/2012,ASU Astro
Dave,163,160,3,1,8,11/20/2011,unaffiliated
hirashita,160,160,0,0,0,02/01/2011,ASIAA
tolga,159,159,0,0,0,04/15/2011,Istanbul University
kenshen,157,157,0,0,0,09/30/2010,UCB
Brett Salmon,157,157,0,0,0,11/18/2011,Texas A&M
csharon,156,156,0,0,0,09/10/2011,Cornell
Nicolas Tejos,156,156,0,1,3,10/19/2012,UCSC
Luis Vargas,155,155,0,0,0,01/27/2012,Yale
Christina Williams,154,154,0,0,0,04/25/2013,UMass Amherst
Ashlee Wilkins,153,153,0,0,1,10/15/2012,University of Maryland
rbarniol,152,152,0,0,0,11/18/2013,Hebrew University
drubin,152,152,0,0,0,05/19/2014,FSU Astrophysics
skking,151,150,1,1,0,02/08/2011,ASIAA
sfore,151,150,1,0,0,12/10/2013,Stanford
ajbattisti,151,151,0,0,0,01/06/2014,UMass Amherst
Milic,150,149,1,0,0,09/17/2011,AOB
swara,150,150,0,0,0,07/29/2013,STScI/JHU
Kevork Abazajian,149,145,4,4,0,02/05/2013,UCI
prateek,148,148,0,2,0,08/31/2010,IISc-RRI
RZ Cas,148,148,0,0,0,09/03/2012,RIT
Pascale Jablonka,147,147,0,0,0,10/19/2011,EPFL - UniGe
MikeHudson,147,147,0,2,4,11/07/2013,University of Waterloo
jfritz,146,145,1,0,0,12/28/2012,Ghent University
thedude,146,146,0,0,0,12/02/2010,CEA Saclay
moriyatk,146,146,0,0,0,03/30/2012,AIfA
Sperello,146,146,0,0,0,01/16/2013,Osservatorio Astrofisico di Arcetri - Extragalactic
Skielboe A.,144,144,0,2,0,11/01/2011,DARK
dreed,144,144,0,0,0,05/29/2012,Zürich
shihping,144,144,0,0,0,03/26/2014,NTHU
Luke,142,142,0,3,0,08/31/2009,Harvard ITC
dhooper,142,142,0,0,2,02/28/2013,Fermilab
Alessandro Ederoclite,141,141,0,0,0,07/02/2013,CEFCA
Isabelle Pâris,141,141,0,0,0,01/09/2014,OATS
n-cowan,140,139,1,0,0,09/22/2010,CIERA
tremblin,140,140,0,0,0,10/08/2013,University of Exeter
jens,139,128,11,1,0,07/01/2010,DARK
lise,139,139,0,0,0,11/30/2011,DARK
huffenbe,138,138,0,0,0,05/22/2014,FSU Astrophysics
John Forbes,137,137,0,0,8,07/16/2010,UCSC
astrojen,137,137,0,0,0,09/06/2011,Columbia
dodorico,137,137,0,0,0,01/08/2014,OATS
wirvine,136,135,1,0,0,03/21/2014,UMass Amherst
Erica June Nelson,135,135,0,0,0,02/11/2012,Yale
beffatotale,135,135,0,2,0,03/06/2013,Osservatorio Astrofisico di Arcetri - Extragalactic
jvangork,134,134,0,0,0,09/09/2010,Columbia
Casey Papovich,134,134,0,0,0,11/28/2011,Texas A&M
jforbrich,133,133,0,0,0,06/06/2012,University of Vienna
villarreala,133,133,0,0,0,08/24/2012,U. Pittsburgh
tina12690,133,133,0,0,0,10/15/2014,NTHU
ryan.oelkers,132,132,0,0,0,12/02/2011,Texas A&M
aseem,132,132,0,0,0,10/05/2012,IUCAA
yara.jaffe,132,132,0,0,0,04/01/2013,"U. de Concepcion: Planetary, Stellar, Galactic, Extragalactic papers"
sloth,131,124,7,1,0,12/02/2010,CEA Saclay
sune,131,126,5,1,0,08/11/2010,DARK
Niraj,131,131,0,1,0,03/31/2011,Oxford University - Galaxies
matthieu.bethermin,131,131,0,0,0,10/22/2011,CEA Saclay
cjcopi,131,131,0,0,0,11/22/2011,unaffiliated
Roberto M,130,129,1,1,0,10/28/2011,PUC-Institute of Astrophysics
Sam Leitner,130,130,0,0,0,11/10/2010,University of Maryland
Tony Piro,130,130,0,0,0,01/10/2012,Carnegie
jwing,129,129,0,0,0,06/09/2011,Boston University
Alvaro Orsi,128,128,0,0,0,04/20/2011,CEFCA
wmwolf,128,128,0,0,0,10/11/2012,UCSB
fdm,128,128,0,0,0,11/16/2012,University of Oklahoma
janewman,127,121,6,0,1,02/03/2011,U. Pittsburgh
Michael Drinkwater,127,127,0,1,0,08/12/2010,UQ
GregSloan,127,127,0,0,0,01/07/2013,Cornell
Jimmy,126,125,1,2,3,11/14/2011,Texas A&M
Matthew Nichols,126,126,0,0,0,01/14/2013,EPFL - UniGe
Schroeder,125,116,9,7,2,09/07/2010,Columbia
Rosalie McGurk,125,125,0,0,7,01/26/2010,UCSC
kadrlica,125,125,0,0,3,08/28/2012,Fermilab
Andrew Pace,125,125,0,0,0,05/06/2013,UCI
Oscar Morata,123,123,0,0,0,01/27/2011,ASIAA
alebrun,123,123,0,0,0,04/14/2013,CEA Saclay
kcooksey,120,120,0,1,0,11/08/2010,University of Hawaii at Hilo
olivier,120,120,0,0,0,12/10/2010,LAM
Steve Finkelstein,119,119,0,0,0,08/23/2011,UT Austin
ariheinze,119,119,0,0,0,02/03/2012,Stony Brook
Alice Olmstead,119,119,0,0,0,10/08/2012,University of Maryland
galtay,119,119,0,7,1,10/31/2012,Georgia Tech
jpforr,119,119,0,0,0,10/14/2014,LAM
Brad,118,118,0,2,6,10/15/2009,UCSC
Coral Wheeler,118,118,0,0,0,01/25/2013,UCI
martdav,117,117,0,1,0,05/25/2012,UCB
James,117,117,0,2,0,10/25/2012,University of Southampton
sarahsweet,117,117,0,0,0,08/05/2014,RSAA-ANU
hooshang,116,112,4,0,0,04/19/2011,UCI
w-farr,116,116,0,0,0,06/29/2010,CIERA
mikiiaa,116,116,0,0,0,02/09/2011,ASIAA
Ben Forrest,116,116,0,0,0,08/29/2012,Texas A&M
manuel,116,116,0,1,3,12/22/2012,Universidad de Costa Rica
esani,116,116,0,0,0,01/17/2013,Osservatorio Astrofisico di Arcetri - Extragalactic
karen,115,115,0,0,0,10/22/2010,DARK
gstarkman,115,115,0,2,0,11/22/2011,unaffiliated
Ami,115,115,0,0,0,10/09/2012,AIfA-Cosmo
Raffa,115,115,0,0,0,01/25/2013,INAF-OAR
DMasters,114,114,0,0,0,04/09/2011,UCR
wenjuan,114,114,0,0,0,10/25/2012,UIUC
ctheissen,113,111,2,0,0,09/20/2011,Boston University
Nicholas,113,112,1,0,2,09/20/2010,"IfA, University of Hawaii"
Jonathan Foster,113,113,0,0,0,06/22/2011,Yale
Christine,112,112,0,3,0,09/08/2010,HITS
Shawn R. Roberts,112,112,0,0,0,01/04/2014,UMass Amherst
kerttu,111,111,0,0,0,10/08/2013,CEFCA
jeremiah,111,111,0,0,0,05/16/2014,FSU Astrophysics
Marianne V,110,107,3,0,0,08/12/2010,DARK
mcoleman,110,109,1,0,0,11/06/2012,UCSB
kknierman,110,110,0,0,0,08/10/2011,ASU Astro
ajbaker,110,110,0,0,0,09/09/2011,Rutgers
Pascal,109,109,0,0,9,01/04/2011,Yale
lia,108,108,0,0,0,09/20/2010,Columbia
paolo,108,108,0,1,0,07/07/2011,LAM
tomczak,108,108,0,0,0,11/17/2011,Texas A&M
Ryan Chaves,108,108,0,0,0,02/13/2012,unaffiliated
dzurek,108,108,0,0,0,12/04/2012,AMNH
alpaca,107,106,1,1,0,12/02/2010,University of Vienna
Alberto Dominguez,107,107,0,0,0,04/02/2010,Clemson
Phil Marshall,107,107,0,2,0,08/23/2012,Stanford
mjrizzo,107,107,0,0,0,10/25/2012,NASA Goddard Space Flight Center
starwyh,106,106,0,0,0,05/01/2014,NTHU
drEvil,105,101,4,5,0,02/04/2013,OSU Astronomy
sgarriso,105,105,0,0,0,01/24/2013,UCI
ezetre,105,105,0,0,0,03/19/2013,"U. de Concepcion: Planetary, Stellar, Galactic, Extragalactic papers"
gonzalo,105,105,0,2,0,09/17/2013,CEFCA
aph15,104,100,4,0,2,02/11/2011,U. Pittsburgh
cpurcell,104,104,0,1,0,02/07/2011,U. Pittsburgh
ilkap,103,103,0,0,0,10/31/2012,AIfA
Wang_tao,103,103,0,0,0,09/09/2013,CEA Saclay
milbog,102,100,2,0,6,09/14/2011,AOB
sjuneau,102,102,0,1,0,11/27/2011,CEA Saclay
vivianu,102,102,0,0,0,08/29/2012,UCR
kellyhb,102,102,0,0,0,09/10/2012,Vanderbilt
edvige,102,102,0,0,0,01/17/2013,Osservatorio Astrofisico di Arcetri - Extragalactic
yuantt,102,102,0,0,0,08/22/2013,RSAA-ANU
Mike Petersen,101,100,1,0,0,10/28/2013,UMass Amherst
Anais Rassat,100,100,0,2,0,01/12/2012,EPFL - UniGe
marilena,100,100,0,0,0,11/16/2012,Chicago-KICP
Juan_Carlos,99,99,0,0,0,04/20/2011,PUC-Institute of Astrophysics
pkurczynski,99,99,0,2,1,09/12/2011,Rutgers
dnarayanan,98,98,0,0,0,04/13/2011,Haverford College
czakon,98,98,0,1,1,10/21/2013,ASIAA
may,98,98,0,0,0,12/17/2013,Boston University
jlotz,97,97,0,0,0,02/10/2011,STScI/JHU
Thomas,97,97,0,0,0,07/06/2011,DARK
sbianchi,97,97,0,0,0,01/16/2013,Osservatorio Astrofisico di Arcetri - Extragalactic
David Parkinson,96,96,0,0,0,09/30/2010,UQ Swinburne Cosmology
mjrutkowski,96,96,0,0,0,08/10/2011,ASU Astro
jk,96,96,0,0,0,09/13/2011,Stony Brook
saurabh,95,95,0,2,0,09/12/2011,Rutgers
atmerritt,95,95,0,0,0,03/19/2012,Yale
rteyssier,95,95,0,0,0,05/16/2012,ICS
Manodeep,95,95,0,0,0,08/09/2012,Vanderbilt
eas342,95,95,0,0,0,09/10/2012,Cornell
dahickey,95,95,0,0,0,12/10/2013,Boston University
Francesco S.,94,94,0,0,0,10/31/2013,University of Southampton
dario,93,93,0,0,0,01/24/2011,LAM
neal,93,93,0,0,0,09/19/2012,UIUC
Kevin Schlaufman,92,92,0,3,8,09/18/2009,MIT Exoplanet Tea
smadar,92,92,0,2,2,06/23/2010,Harvard ITC
liran827,92,92,0,0,0,09/15/2010,NAOC
RichardTunnard,92,92,0,0,0,03/18/2014,UCL Extragalactic Journal Club
Maxime Trebitsch,91,91,0,0,0,09/14/2012,CRAL
Cliff,91,91,0,0,0,11/09/2012,Oxford University - Galaxies
Kaveh,91,91,0,0,0,01/24/2013,UCR
rdawson,90,90,0,5,0,08/04/2012,UCB
sguillot,90,90,0,0,0,09/26/2012,McGill
Flor,90,90,0,0,0,11/23/2012,Ghent University
Madigan,87,87,0,0,0,11/29/2010,UCB
pana,87,87,0,0,0,09/12/2011,STScI/JHU
Chien-Cheng Lin,87,87,0,0,15,09/17/2013,SHAO
simone,86,86,0,0,0,11/08/2011,University of Vienna
xun,85,85,0,0,0,07/14/2010,MPA Garching
comerford,85,85,0,0,2,07/18/2011,UT Austin
H. Kim,85,85,0,1,0,08/11/2011,UT Austin
JRSchmitt,85,85,0,0,0,08/30/2012,Yale-Planets
Hai Fu,85,85,0,0,0,02/05/2013,University of Iowa
Massimo,85,85,0,0,0,04/03/2013,University of Milano-Bicocca
Mathieu,84,83,1,0,2,04/04/2011,IAS Orsay
spardy,84,84,0,0,0,09/25/2013,UW Madison
bbenson,83,81,2,1,0,11/16/2012,Chicago-KICP
Volker,83,83,0,0,0,05/25/2012,ICS
srmeeker,83,83,0,0,0,10/11/2012,UCSB
Andrew Graus,83,83,0,0,0,09/26/2013,UCI
fardal,83,83,0,0,0,01/23/2014,UMass Amherst
mmechtley,82,82,0,0,0,08/11/2011,ASU Astro
l.wang,82,82,0,0,0,09/10/2011,KIAA-Clusters
kn,82,82,0,0,0,03/05/2012,UNLV
Zach Jennings,82,82,0,0,2,09/17/2012,UCSC
tao,82,82,0,0,0,11/05/2013,NTHU
cmorley,81,81,0,0,4,09/24/2010,UCSC
mschalle,81,81,0,0,0,10/21/2012,Durham University
gmeece,81,81,0,0,0,01/21/2013,Michigan State
Valiante,81,81,0,0,0,01/25/2013,INAF-OAR
pjames,81,81,0,0,0,04/09/2013,LJMU
marius.cautun,81,81,0,0,0,09/20/2013,Durham University
ajeeson,81,81,0,0,0,02/06/2014,University of Melbourne
J-Rod,79,78,1,1,0,01/14/2013,U. Pittsburgh
Sara,79,79,0,1,0,07/06/2010,CIERA
nmartinovic,79,79,0,0,0,09/16/2011,AOB
cavestruz,79,79,0,0,0,04/04/2012,Yale
rukmani,79,79,0,0,0,09/19/2012,UIUC
yuanyuan,79,79,0,0,0,12/05/2012,UCI
Andreas Faisst,78,78,0,0,0,06/22/2011,ETH-Extragalactic
craigrudick,78,78,0,0,0,06/23/2011,ETH-Extragalactic
ripisc,78,78,0,0,0,05/13/2013,LJMU
eMat,78,78,0,0,0,12/02/2013,AIfA
avishay,78,78,0,0,0,09/10/2014,Weizmann Institute of Science
cgiguere,77,77,0,0,0,09/09/2010,UCB
Lousto,77,77,0,0,0,10/25/2014,RIT-CCRG
John Wise,76,76,0,0,4,03/02/2012,Georgia Tech
michael_z,76,76,0,0,0,09/18/2012,McGill
jphillips,76,76,0,0,0,01/24/2013,UCI
JesusVarela,76,76,0,3,0,09/10/2013,CEFCA
Edmond,75,74,1,1,2,02/16/2010,Kavli IPMU
jpk,75,74,1,0,0,12/10/2010,LAM
Michael Berry,75,75,0,0,0,09/15/2011,Rutgers
oczoske,75,75,0,0,0,11/03/2011,University of Vienna
tfinzell,75,75,0,0,0,02/17/2013,Michigan State
Daniel Fabrycky,74,74,0,3,1,09/08/2010,Chicago-KICP
fcivano,74,74,0,3,0,09/23/2010,Harvard ITC
egpbos,74,74,0,2,0,01/06/2011,Kapteyn
hshwang,73,73,0,0,0,12/02/2010,unaffiliated
wqd,73,73,0,0,0,02/27/2011,U. Mass
Richard de Grijs,73,73,0,0,0,09/08/2011,KIAA-Clusters
julian.bautista,73,73,0,0,0,01/10/2013,University of Utah
Hugo,73,73,0,0,0,01/17/2013,Universidad de Costa Rica
pdh21,73,73,0,0,0,09/19/2013,"U. of Sussex, Astronomy Centre"
malexander,73,73,0,1,0,02/07/2014,Lehigh University
StefanUttenthaler,72,71,1,5,0,11/04/2011,University of Vienna
mirko,72,72,0,0,0,04/19/2011,PUC-Institute of Astrophysics
Thomas Bschorr,72,72,0,0,0,06/28/2011,ETH-Extragalactic
Alexandre Boucaud,72,72,0,0,0,01/10/2013,IAS Orsay
Xinwen Shu,72,72,0,0,0,09/03/2013,CEA Saclay
chummels,71,69,2,0,0,09/08/2010,Arizona
bournaud,71,71,0,0,0,12/02/2010,CEA Saclay
Heath Shipley,71,71,0,0,0,01/19/2012,Texas A&M
Antonio J. Cuesta,71,71,0,0,0,01/27/2012,ICCUB
abonaca,71,71,0,0,0,01/28/2012,Yale
JuanHernandez,71,71,0,0,0,10/25/2012,University of Southampton
jggalbra,71,71,0,0,0,01/06/2014,University of Utah
Rodrigo Contreras Ramos,71,71,0,0,0,01/20/2014,PUC-Institute of Astrophysics
pmarchan,70,70,0,0,0,04/20/2011,PUC-Institute of Astrophysics
talt,70,70,0,0,6,01/27/2012,UCSC
chm,70,70,0,0,0,07/01/2013,CEFCA
ericagol,70,70,0,0,0,03/07/2014,University of Washington
mikesol,69,69,0,0,0,09/12/2011,Rutgers
npadmana,68,68,0,0,0,01/27/2012,Yale-LSS
James Bullock,68,68,0,0,0,04/02/2012,UCI
sravani vaddi,68,68,0,0,0,09/25/2012,RIT
rpconnol,68,68,0,0,0,01/17/2013,Michigan State
warrickball,68,68,0,0,0,01/25/2013,UniGoettingen
sabrinacales,68,68,0,0,0,03/20/2013,"U. de Concepcion: Planetary, Stellar, Galactic, Extragalactic papers"
akwa,68,68,0,0,0,06/20/2013,UCI
jrvander,68,68,0,0,0,11/08/2013,NMSU
savaglio,67,67,0,0,0,11/02/2011,MPA Garching
observandum,67,67,0,0,0,04/13/2012,IATE
ffragkoudi,67,67,0,0,0,09/05/2012,LAM
clackner,67,67,0,0,0,09/06/2012,Kavli IPMU
tijmen,67,67,0,0,0,09/30/2012,McGill
russellsmith,67,67,0,0,0,10/17/2012,Durham University
vtoy,67,67,0,0,0,11/02/2012,NASA Goddard Space Flight Center
maraya,67,67,0,0,0,01/17/2013,Universidad de Costa Rica
rf.shen,67,67,0,0,0,11/13/2013,Hebrew University
jpepper,67,67,0,0,1,02/04/2014,Lehigh University
thashimoto,67,67,0,0,0,04/02/2014,University of Tokyo
nate_bastian,66,66,0,0,0,03/18/2011,LJMU
henrique xavier,66,66,0,0,0,05/26/2011,UPenn
pagnotta,66,66,0,0,0,02/11/2013,AMNH
ribamar,66,66,0,0,0,05/14/2013,UFRJ
casassanti,66,66,0,0,1,12/20/2013,University of Heidelberg ITP/ITA
phibon,65,65,0,0,0,10/18/2012,Gemini-South
sashakozyreva,65,65,0,0,0,10/19/2012,AIfA
Ashniet,65,65,0,0,0,03/20/2013,"U. de Concepcion: Planetary, Stellar, Galactic, Extragalactic papers"
LottieC,65,65,0,0,0,09/18/2013,"U. of Sussex, Astronomy Centre"
tmtripp,65,65,0,0,0,01/22/2014,UMass Amherst
corbett,64,63,1,0,1,05/28/2012,Zürich
verhamme,64,64,0,0,0,08/23/2011,CRAL
mpeth,64,64,0,0,0,09/14/2011,STScI/JHU
hsheets,64,64,0,0,0,10/15/2012,University of Maryland
JoachimVanderbeke,64,64,0,0,0,01/23/2013,Ghent University
Lisa Kewley,64,64,0,0,0,09/30/2013,RSAA-ANU
pah,64,64,0,0,0,05/17/2014,FSU Astrophysics
brandon bozek,63,63,0,0,0,02/01/2011,University of Maryland
Philip Muirhead,63,63,0,0,0,07/13/2011,Boston University
kmoore,63,63,0,0,1,02/16/2012,UCSC
ChengyuanLi,63,63,0,7,0,04/12/2012,KIAA-Clusters
skamann,63,63,0,0,0,03/14/2013,UniGoettingen
trouille,62,62,0,0,0,08/11/2010,CIERA
aarongeller,62,62,0,0,0,08/11/2010,CIERA
alupi,62,62,0,0,0,04/05/2013,University of Milano-Bicocca
p_rooney,62,62,0,0,0,10/24/2013,"U. of Sussex, Astronomy Centre"
Avery Broderick,62,62,0,0,0,11/22/2013,University of Waterloo
chargedcurrent,62,62,0,0,0,03/19/2014,OSU Astronomy
takatanaka,61,61,0,0,0,09/07/2010,MPA Garching
pcerulo,61,61,0,0,0,02/24/2011,Swinburne
Gaby,61,61,0,0,0,07/20/2011,UCR
aleks,61,61,0,0,0,08/19/2011,DIAS
Till,61,61,0,0,0,07/02/2012,Durham University
mattsson,60,59,1,0,0,05/23/2011,DARK
griffen,60,60,0,0,0,08/05/2010,MIT
dpmorg,60,60,0,0,0,06/22/2011,Boston University
JimM,60,60,0,0,0,11/21/2011,unaffiliated
boada,60,60,0,0,0,11/21/2011,Texas A&M
revaz,60,60,0,0,0,01/12/2012,EPFL - UniGe
Daniel Nagasawa,60,60,0,0,0,08/28/2012,Texas A&M
vorobiev_rit,60,60,0,0,0,09/06/2012,RIT
Benjamin Bertincourt,60,60,0,0,0,11/08/2012,IAS Orsay
kfb,60,60,0,0,0,11/14/2013,SAC
mqk,59,59,0,1,0,08/23/2010,UCB
lt,59,59,0,0,0,01/18/2011,LAM
sgeen,59,59,0,0,0,09/08/2011,CRAL
risa,59,59,0,0,0,07/17/2012,Stanford
Holger,58,58,0,0,0,08/08/2010,UQ
oelbert,58,58,0,0,0,01/31/2013,UCI
larogers,57,57,0,0,0,11/09/2010,MIT
Dominique,57,57,0,0,0,11/14/2011,AIfA-Cosmo
rachelbez,57,57,0,0,0,01/27/2012,Arizona
Volker Heesen,57,57,0,0,0,11/21/2012,University of Southampton
guillem,57,57,0,0,0,01/31/2013,UniGoettingen
hettin12,56,54,2,0,0,12/10/2012,Michigan State
deapplegate,56,55,1,2,3,08/17/2012,AIfA-Cosmo
Marie,56,56,0,0,0,02/18/2011,Swinburne
alireza,56,56,0,0,0,04/11/2011,UCR
jmonkiew,56,56,0,0,0,08/22/2011,ASU Astro
ana.lalovic,56,56,0,0,1,10/29/2011,AOB
srepetto,56,56,0,2,0,10/10/2013,Radboud University Nijmegen
andreas kuepper,56,56,0,0,0,10/22/2013,Columbia
roni181066,56,56,0,0,0,09/10/2014,Weizmann Institute of Science
Javiera Guedes,55,55,0,1,2,10/26/2009,ETH-Extragalactic
lauragreen,55,55,0,0,0,04/19/2011,UCR
Michel Zamojski,55,55,0,0,0,01/12/2012,EPFL - UniGe
mjohnson,55,55,0,0,0,05/16/2012,UT Austin
rcheng,55,55,0,0,2,08/31/2012,Johns Hopkins
BrunoRibeiro,55,55,0,0,0,10/03/2013,LAM
Bill Green,55,55,0,2,0,05/21/2014,FSU Astrophysics
alexie,54,54,0,0,0,08/25/2010,Kavli IPMU
darrencroton,54,54,0,0,0,02/10/2011,Swinburne
pazelaya,54,54,0,0,0,03/27/2011,PUC-Institute of Astrophysics
mainpal,54,54,0,0,0,08/18/2012,IUCAA
ssaito,54,54,0,0,0,09/17/2012,Kavli IPMU
Rok,54,54,0,1,0,09/26/2012,Zürich
tshimizu,54,54,0,0,0,10/19/2012,University of Maryland
sumit,54,54,0,1,0,05/30/2013,U. Pittsburgh
kschles,54,54,0,0,0,08/26/2013,RSAA-ANU
dieunguyen,54,54,0,0,0,02/08/2014,University of Utah
gaccurso,54,54,0,0,0,03/04/2014,UCL Extragalactic Journal Club
mstalevski,54,54,0,0,0,03/18/2014,UChile - Calan
Eda,54,54,0,0,0,06/08/2014,Istanbul University
DanFeldman,53,51,2,0,0,11/22/2013,Boston University
Amanda,53,52,1,0,0,11/21/2011,unaffiliated
shulevski,53,53,0,0,1,01/05/2011,Kapteyn
denbrok,53,53,0,0,0,01/07/2011,University of Utah
ethlau,53,53,0,0,0,02/01/2012,Yale
Xue-Jian Jiang,53,53,0,0,0,10/17/2013,Nanjing University
taa,52,52,0,0,0,08/10/2011,ASU Astro
scotty2h,52,52,0,0,1,12/06/2011,unaffiliated
sigrimm,52,52,0,0,0,05/30/2012,ICS
lchomiuk,52,52,0,0,0,12/12/2012,Michigan State
mpeacock,52,52,0,0,0,01/15/2013,Michigan State
veicht,52,52,0,0,0,02/18/2013,AMNH
Dirk Lennarz,52,52,0,0,0,04/10/2013,Georgia Tech
Karl Gordon,52,52,0,0,0,06/26/2014,STScI/JHU
zbertathompson,52,52,0,0,0,08/28/2014,MIT Exoplanet Tea
Gabor,51,50,1,2,8,07/28/2009,unaffiliated
Angie,51,51,0,2,10,02/21/2010,UCSC
margrethe,51,51,0,0,0,07/29/2010,DARK
Leo C. Stein,51,51,0,3,2,11/08/2010,Cornell
steaua,51,51,0,34,0,11/03/2011,University of Vienna
mehdi,51,51,0,0,0,12/06/2011,UMN
nho,51,51,0,0,0,04/18/2012,Yale
ahubbard,51,51,0,0,0,03/04/2013,AMNH
shunsaku.horiuchi,51,51,0,0,0,03/07/2013,UCI
kmeagher,51,51,0,0,0,04/03/2013,Georgia Tech
jteske,50,50,0,7,0,04/16/2011,Carnegie DTM
hacar,50,50,0,0,0,05/29/2012,University of Vienna
Yao,50,50,0,0,0,08/07/2012,Stanford
lkhunt,50,50,0,0,0,01/16/2013,Osservatorio Astrofisico di Arcetri - Extragalactic
Marci,50,50,0,0,0,01/26/2013,INAF-OAR
Vlas Sokolov,50,50,0,2,0,02/24/2014,NTHU
agoulding,49,48,1,0,0,10/04/2010,HEAD-CfA
Cecile Faure,49,48,1,0,0,01/12/2012,EPFL - UniGe
vassiliki,49,49,0,0,0,07/11/2010,CIERA
gpopping,49,49,0,0,0,02/04/2011,Kapteyn-HI
Nicole,49,49,0,0,0,05/05/2011,IAS Orsay
dgrin,49,49,0,0,0,07/13/2011,Chicago-KICP
tuttle,49,49,0,0,0,07/25/2011,UT Austin
san,49,49,0,0,0,08/11/2011,DARK
KrisEriksen,49,49,0,0,0,09/09/2011,Rutgers
oguri,49,49,0,0,0,03/30/2012,Kavli IPMU
garciaev,49,49,0,1,0,08/07/2012,Vanderbilt
kostasg,49,49,0,0,0,09/18/2012,McGill
bfulton,49,49,0,0,0,09/19/2012,"IfA, University of Hawaii"
aarchiba,49,49,0,2,0,09/27/2012,McGill
cschreib,49,49,0,0,0,10/03/2012,CEA Saclay
jlinford,49,49,0,0,0,07/29/2013,Michigan State
bhughey,48,48,0,0,0,11/15/2010,UW Milwaukee
mattia,48,48,0,0,0,12/02/2010,Leiden
p.anders,48,48,0,0,0,09/08/2011,unaffiliated
DanDicken,48,48,0,0,0,10/17/2011,IAS Orsay
masahiro.takada,48,48,0,0,0,03/30/2012,Kavli IPMU
pnb,48,48,0,0,0,10/19/2012,Edinburgh
drewhogg,48,48,0,0,0,04/19/2013,University of Maryland
as721,48,48,0,0,0,09/18/2013,ICS
MikkelNL,48,48,0,0,4,10/22/2013,SAC
Malte Tewes,47,45,2,1,0,01/12/2012,AIfA-Cosmo
jwinn,47,47,0,0,0,11/08/2010,MIT
Solinsky,47,47,0,0,0,03/14/2011,U. Pittsburgh
Paul Barklem,47,47,0,0,2,08/09/2011,Uppsala
Tim,47,47,0,0,0,08/25/2011,U. Pittsburgh
sellwood,47,47,0,0,0,09/09/2011,Rutgers
Agnes,47,47,0,0,0,10/23/2011,IAS Orsay
Amit Kashi,47,47,0,1,0,03/03/2012,UNLV
djfarrow,47,47,0,0,0,10/22/2012,Durham University
jicapone,47,47,0,0,0,11/05/2012,NASA Goddard Space Flight Center
jwiener,47,47,0,0,0,02/27/2013,UCSB
Karen Masters,47,47,0,0,0,08/19/2013,ICG Portsmouth
colless,47,47,0,0,0,08/22/2013,RSAA-ANU
chisholm,47,47,0,0,0,09/16/2013,UW Madison
afont,47,47,0,0,0,10/15/2013,UCB cosmology
jfortney,46,46,0,1,0,08/31/2010,UCSC
JM,46,46,0,0,0,06/22/2011,Boston University
mverdugo,46,46,0,0,0,03/14/2012,University of Vienna
charles,46,46,0,0,0,09/19/2012,UIUC
fung,46,46,0,0,0,10/03/2012,UofT
cmh,46,46,0,0,0,10/17/2012,Durham University
jfwu,46,46,0,0,0,06/28/2013,Rutgers
karraki,46,46,0,0,0,11/02/2013,NMSU
asilvest,46,46,0,0,0,01/23/2014,SISSA
Steven,45,45,0,0,0,11/22/2010,Kapteyn
westmoquette,45,45,0,1,0,03/10/2011,ESO Garching
jchaname,45,45,0,0,0,04/26/2011,PUC-Institute of Astrophysics
cpower,45,45,0,0,0,09/21/2011,ICRAR
kbundy,45,45,0,0,0,03/28/2012,Kavli IPMU
emieda,45,45,0,0,0,10/03/2012,UofT
jdfraine,45,45,0,0,0,10/09/2012,University of Maryland
Hansung,45,45,0,0,0,01/04/2014,UMass Amherst
serena.perrotta,45,45,0,0,0,01/10/2014,OATS
bcfriesen,45,45,0,0,0,01/16/2014,University of Oklahoma
mhilker,44,43,1,0,0,03/11/2011,ESO Garching
ia,44,44,0,0,0,10/18/2010,DARK
justinread,44,44,0,0,0,06/23/2011,ETH-Extragalactic
bastie,44,44,0,0,0,11/04/2011,University of Vienna
elinor_lev,44,44,0,0,0,11/09/2011,STScI/JHU
daw,44,44,0,0,0,01/27/2012,UW Madison
kawinwanichakij,44,44,0,0,0,08/28/2012,Texas A&M
ahopkins,44,44,0,0,0,01/30/2013,AAO
Juan Ibañez-Mejia,44,44,0,0,0,02/22/2013,AMNH
Miguel Quartin,44,44,0,0,0,05/17/2013,UFRJ
nickkaiser,44,44,0,1,0,07/08/2013,"IfA, University of Hawaii"
rsalinas,44,44,0,0,0,08/12/2013,Michigan State
fvalentino,44,44,0,0,0,09/19/2013,CEA Saclay
hotokezaka,44,44,0,0,0,04/03/2014,Hebrew University
pfeffer,43,43,0,0,0,08/06/2010,UQ
Roban Kramer,43,43,0,0,0,06/22/2011,ETH-Extragalactic
egawiser,43,43,0,0,0,09/12/2011,Rutgers
tonywong,43,43,0,0,0,09/21/2011,UIUC
derg,43,43,0,0,0,09/04/2012,Cornell
dbwestman,43,43,0,2,0,10/14/2012,University of Washington
gfeiden,43,43,0,0,0,01/21/2013,Uppsala
statia,43,43,0,0,0,02/11/2013,AMNH
ross1987,43,43,0,0,0,04/19/2013,University of Milano-Bicocca
sherry,43,43,0,0,0,10/20/2013,ASIAA
Brett Andrews,43,43,0,0,0,03/20/2014,U. Pittsburgh
cmccully,42,42,0,0,0,09/14/2011,LCOGT
Charlie,42,42,0,1,0,04/25/2012,UCSC
pbrown801,42,42,0,0,2,06/15/2012,Texas A&M
matt_schell,42,42,0,0,0,07/30/2012,U. Pittsburgh
jpl,42,42,0,0,0,09/10/2012,Cornell
D. F. Watson,42,42,0,0,0,01/23/2013,Chicago-KICP
maxpkatz,42,42,0,0,0,03/11/2013,Stony Brook
bolejko,42,42,0,0,0,08/21/2013,SIfA
Jonás,42,42,0,0,0,09/17/2013,CEFCA
m.browning,42,42,0,0,0,10/04/2013,University of Exeter
vsilvagui,42,42,0,0,0,11/12/2013,SAC
Haojie,42,42,0,0,0,12/10/2013,University of Utah
Johan Samsing,41,41,0,0,0,08/05/2010,DARK
evoyer,41,41,0,0,0,09/14/2011,LAM
reangulo,41,41,0,0,0,11/03/2011,CEFCA
ferreroismael,41,41,0,0,0,04/12/2012,IATE
Andreas Berlind,41,41,0,0,0,08/06/2012,Vanderbilt
Elizabeth,41,41,0,0,0,09/10/2012,U. Pittsburgh
Jamie Lomax,41,41,0,0,0,01/16/2014,University of Oklahoma
hristovb,41,41,0,0,0,05/18/2014,FSU Astrophysics
jesse.vd.sande,40,40,0,0,0,11/16/2010,Leiden
trainor,40,40,0,0,0,12/01/2010,Caltech
Ali,40,40,0,1,0,12/02/2010,ICS
Felipe Menanteau,40,40,0,0,0,09/08/2011,UIUC
bpatel02,40,40,0,0,0,09/09/2011,Rutgers
sdriver,40,40,0,0,0,09/21/2011,ICRAR
betsey,40,40,0,0,0,08/20/2012,Cornell
pacargile,40,40,0,0,0,09/04/2012,Vanderbilt
rarchiba,40,40,0,0,1,09/18/2012,McGill
ltibaldo,40,40,0,0,0,10/02/2012,Stanford
mrlovell,40,40,0,0,0,10/17/2012,Durham University
engelen,40,40,0,0,0,11/01/2012,Stony Brook
Damien,40,40,0,0,1,08/01/2013,MoCA
dzliu,40,40,0,0,0,10/10/2013,CEA Saclay
shoenig,40,40,0,0,0,11/15/2013,University of Southampton
cabrera-ziri,40,40,0,1,0,04/17/2014,LJMU
sarahsweet,39,39,0,0,0,08/12/2010,UQ
mlarichardson,39,39,0,0,0,08/17/2011,Oxford University - Galaxies
nwright,39,39,0,0,0,10/21/2011,University of Hertfordshire
Luke Keltner,39,39,0,0,0,11/22/2011,unaffiliated
Sandro Tacchella,39,39,0,0,0,12/19/2011,ETH-Extragalactic
Sandro Tacchella,39,39,0,0,0,02/07/2012,ETH-Extragalactic
e.papastergis,39,39,0,0,0,08/10/2012,Kapteyn-HI
michaelT,39,39,0,0,0,10/26/2012,University of Washington
bryan.matamoros,39,39,0,0,0,01/17/2013,Universidad de Costa Rica
Jose Onorbe,39,39,0,0,0,02/05/2013,unaffiliated
ezbc,39,39,0,0,0,09/16/2013,UW Madison
scottclay,39,39,0,0,0,09/18/2013,"U. of Sussex, Astronomy Centre"
eakruse,39,39,0,0,0,10/04/2013,University of Washington
Joshua Wing,39,39,0,0,0,10/18/2013,Harvard ITC
jbestenlehner,39,39,0,0,0,03/10/2014,AIfA
George Privon,39,39,0,0,0,09/24/2014,"U. de Concepcion: Planetary, Stellar, Galactic, Extragalactic papers"
connor,38,36,2,0,0,01/15/2013,Michigan State
Aida Wofford,38,37,1,0,0,09/12/2011,IAP Cosmology and Extragalactic
Robert M,38,37,1,8,0,10/28/2011,Penn State
raquelfraga,38,37,1,0,0,11/15/2013,Radboud University Nijmegen
Morgan MacLeod,38,38,0,0,5,09/28/2010,Harvard ITC
esratigrak,38,38,0,0,0,01/04/2011,Kapteyn
arunima,38,38,0,0,0,07/06/2011,IISc-RRI
surhud,38,38,0,0,0,08/02/2011,Kavli IPMU
satoki,38,38,0,0,0,10/27/2011,ASIAA
alejandrobll,38,38,0,0,0,04/13/2012,IATE
jeverett,38,38,0,0,0,06/18/2012,CIERA
Baile,38,38,0,0,0,09/15/2012,Vanderbilt
iprn,38,38,0,0,0,10/16/2012,Durham University
AMann,38,38,0,0,0,02/10/2013,UT Austin
pszypryt,38,38,0,0,0,10/18/2013,UCSB
feuilldk,38,38,0,0,0,11/06/2013,NMSU
Paul Geil,38,38,0,0,0,03/13/2014,University of Melbourne
annalisa,38,38,0,0,0,09/14/2014,Weizmann Institute of Science
amatas,37,36,1,0,3,12/01/2011,unaffiliated
ardis,37,37,0,0,0,11/02/2010,DARK
nnelson,37,37,0,2,1,11/04/2010,LANL
Michael Pavel,37,37,0,0,0,06/09/2011,UT Austin
nino,37,37,0,3,4,07/01/2011,NASA Goddard Space Flight Center
kwduong,37,37,0,0,0,08/17/2011,ASU Astro
paulg,37,37,0,0,0,09/12/2011,STScI/JHU
trouille_adler,37,37,0,11,2,08/07/2012,Adler Planetarium
erozo,37,37,0,0,0,10/04/2012,Stanford
alesonny,37,37,0,0,0,10/11/2012,UCSB
bolatto,37,37,0,0,0,10/23/2012,University of Maryland
Monika M.,37,37,0,0,0,11/18/2012,Radboud University Nijmegen
Neven Caplar,37,37,0,1,0,02/04/2013,ETH-Extragalactic
stef,37,37,0,0,0,02/04/2013,UCR
gavazzi,37,37,0,0,0,04/19/2013,University of Milano-Bicocca
abrooks,37,37,0,0,0,08/23/2013,Rutgers
Sharon Xuesong Wang,37,37,0,2,0,09/26/2013,Penn State
tsvi,37,37,0,0,0,11/19/2013,Hebrew University
rcwh,37,37,0,1,0,02/07/2014,Oxford University - Galaxies
Ofer,37,37,0,0,0,09/09/2014,Weizmann Institute of Science
dhaggard,36,36,0,0,0,09/21/2010,CIERA
bane,36,36,0,0,0,09/16/2011,AOB
pancoast,36,36,0,0,0,06/13/2012,UCSB
cfaesi,36,36,0,0,0,08/06/2012,Harvard ITC
tracy,36,36,0,0,0,10/24/2012,McGill
kgarofali,36,36,0,0,0,10/26/2012,University of Washington
Consolandi,36,36,0,0,0,04/19/2013,University of Milano-Bicocca
sam.mcdermott,36,36,0,1,0,09/09/2013,Fermilab
jendrews,36,36,0,0,0,11/11/2013,UMass Amherst
Matthew Brorby,36,36,0,0,0,01/13/2014,University of Iowa
ParamitaBarai,36,36,0,0,0,01/14/2014,OATS
gbpoole,36,36,0,0,0,02/10/2014,University of Melbourne
Sarah Schon,36,36,0,0,0,02/13/2014,University of Melbourne
abensonca,35,34,1,0,0,11/16/2010,Carnegie
ebressert,35,34,1,0,0,03/10/2011,ESO Garching
iprafols,35,34,1,0,0,10/23/2013,ICCUB
ecekilerci,35,35,0,0,0,01/24/2011,DARK
kosowsky,35,35,0,0,0,02/21/2011,U. Pittsburgh
gmorales,35,35,0,0,0,03/30/2011,PUC-Institute of Astrophysics
Ruth Durrer,35,35,0,0,1,02/15/2012,Geneva Cosmology Group
kconroy,35,35,0,0,0,09/04/2012,Vanderbilt
nancykhine,35,35,0,0,0,06/18/2013,University of Hertfordshire
aalbert,35,35,0,0,0,08/20/2013,Stanford
Fedja Kadribasic,35,35,0,0,0,09/04/2013,Texas A&M
D_Pfenniger,34,32,2,0,0,01/19/2012,EPFL - UniGe
dmlee,34,34,0,0,0,09/07/2010,Columbia
Peter Maksym,34,34,0,0,0,09/23/2010,CIERA
cedric.collet,34,34,0,0,0,05/06/2011,IAS Orsay
lukebarnes,34,34,0,0,0,06/23/2011,SIfA
chalence,34,34,0,0,0,07/29/2011,UT Austin
afox,34,34,0,0,0,09/13/2011,STScI/JHU
stephan@pha.jhu.edu,34,34,0,0,0,09/14/2011,STScI/JHU
Nova,34,34,0,0,0,11/04/2011,University of Vienna
Ivan,34,34,0,0,0,12/02/2011,UT Austin
AnneV,34,34,0,0,0,09/13/2012,EPFL - UniGe
Roman Shcherbakov,34,34,0,1,0,10/15/2012,University of Maryland
mlam,34,34,0,0,1,01/09/2013,Cornell
Laurens Keek,34,34,0,0,0,01/15/2013,Georgia Tech
jpratt,34,34,0,0,0,10/07/2013,University of Exeter
batman,34,34,0,0,0,10/28/2013,RSAA-ANU
Sanjaya,33,32,1,0,0,03/12/2012,CEA Saclay
ximena,33,33,0,0,0,09/09/2010,Columbia
Devin Silvia,33,33,0,0,0,11/04/2010,Michigan State
beygu,33,33,0,0,0,01/06/2011,Kapteyn-HI
Masato Onodera,33,33,0,0,0,06/22/2011,ETH-Extragalactic
isa,33,33,0,0,0,06/22/2011,UNAB
billfreeman,33,33,0,0,1,11/06/2011,UCR
davidalgorry,33,33,0,0,0,04/12/2012,IATE
tonyyli,33,33,0,0,0,09/25/2012,Stanford
yomori,33,33,0,0,0,09/26/2012,McGill
ivana.orlitova,33,33,0,0,0,10/08/2012,EPFL - UniGe
mjavara,33,33,0,0,0,10/15/2012,University of Maryland
Christopher Greer,33,33,0,0,0,10/20/2012,Arizona
Abhishek,33,33,0,0,0,10/22/2012,U. Pittsburgh
arnalte,33,33,0,0,0,11/06/2012,Durham University
wbest,33,33,0,0,0,02/07/2013,"IfA, University of Hawaii"
martynbristow,33,33,0,0,0,04/09/2013,LJMU
Matt Giguere,33,33,0,0,0,04/28/2013,Yale-Planets
mcmiller,33,33,0,0,0,09/05/2013,University of Maryland
sarahm,33,33,0,0,0,09/18/2013,AAO
shawnh,33,33,0,0,0,11/14/2013,Cornell-Cosmo
jzavala,33,33,0,0,0,11/14/2013,DARK
evan66210,33,33,0,0,0,01/16/2014,University of Oklahoma
mscrimgeour,33,33,0,0,0,01/17/2014,University of Waterloo
etescari,33,33,0,0,0,02/10/2014,University of Melbourne
rcartier,33,33,0,0,0,03/24/2014,UChile - Calan
Rebecca,32,31,1,1,0,04/11/2011,Swinburne
Neil,32,32,0,1,2,07/25/2009,UCSC
petigura,32,32,0,0,0,08/26/2010,"IfA, University of Hawaii"
eebanado,32,32,0,0,0,04/01/2011,PUC-Institute of Astrophysics
tadpryor,32,32,0,0,0,09/12/2011,Rutgers
jph,32,32,0,0,0,09/14/2011,Rutgers
micic,32,32,0,0,0,09/16/2011,AOB
Ananda Hota,32,32,0,0,0,11/25/2011,GMRT-science
scorbel,32,32,0,0,0,02/15/2012,CEA Saclay High Energy
guillermobc,32,32,0,0,3,03/08/2012,UCSC
J. E. Ybarra,32,32,0,0,1,08/22/2012,IA-UNAM Ensenada
tc,32,32,0,0,0,09/18/2012,Durham University
konboutsia,32,32,0,0,0,02/13/2013,INAF-OAR
Pieter van Dokkum,32,32,0,2,0,03/29/2013,Yale
iraklis,32,32,0,0,0,04/08/2013,AAO
benburningham,32,32,0,0,0,07/12/2013,University of Hertfordshire
alaina.henry,32,32,0,0,0,08/23/2013,NASA GSFC Extragalactic
jamesetaylor,32,32,0,0,0,11/22/2013,University of Waterloo
quidditymaster,32,32,0,0,0,01/06/2014,University of Utah
Allison Youngblood,31,31,0,0,0,11/05/2010,CU Boulder
sboissier,31,31,0,0,0,01/20/2011,LAM
jmorin,31,31,0,0,0,08/19/2011,UniGoettingen
slhoffmann,31,31,0,0,0,11/18/2011,Texas A&M
Ting,31,31,0,0,0,01/24/2012,Texas A&M
mgeha,31,31,0,0,0,01/27/2012,Yale
Elisa Toloba,31,31,0,0,3,02/22/2012,UCSC
feldmann,31,31,0,0,0,09/18/2012,UCB
fbuitrago,31,31,0,1,0,10/11/2012,Edinburgh
kari,31,31,0,0,0,10/17/2012,MPA Garching
Gert De Geyter,31,31,0,1,0,11/05/2012,Ghent University
fmannucci,31,31,0,0,0,01/16/2013,Osservatorio Astrofisico di Arcetri - Extragalactic
Gera,31,31,0,0,5,01/21/2013,Universidad de Costa Rica
agus10al,31,31,0,0,0,01/24/2013,Universidad de Costa Rica
agrazian,31,31,0,0,0,01/25/2013,INAF-OAR
debrafischer,31,31,0,3,0,05/03/2013,Yale-Planets
wj198414,31,31,0,0,0,05/10/2013,Yale-Planets
Andreu,31,31,0,0,0,10/23/2013,ICCUB
sebastian,31,31,0,0,0,11/06/2013,ICS
Benjamin Clément,30,30,0,0,0,01/18/2011,CRAL
srao,30,30,0,0,0,03/02/2011,U. Pittsburgh
jjhermes,30,30,0,0,0,07/25/2011,University of Warwick
kgulliks,30,30,0,0,0,07/27/2011,UT Austin
Yiqing,30,30,0,6,0,09/11/2011,PKU
Rui Xue,30,30,0,0,0,09/15/2011,unaffiliated
pwsully,30,30,0,0,0,05/16/2012,MIT
Courtney,30,30,0,0,0,08/08/2012,Harvard ITC
ari,30,30,0,0,0,01/21/2013,Universidad de Costa Rica
ulemke,30,30,0,0,0,01/28/2013,UniGoettingen
Camila,30,30,0,0,0,02/13/2014,University of Melbourne
tanderton,30,30,0,0,0,08/27/2014,University of Utah
vstrazzu,29,29,0,0,0,12/03/2010,CEA Saclay
berenice,29,29,0,0,0,02/01/2011,Leiden-NOLG
brb,29,29,0,0,0,02/16/2011,U. Pittsburgh
mdouspis,29,29,0,0,0,04/08/2011,IAS Orsay
sobral,29,29,0,0,0,09/15/2011,Leiden
thijskouwenhoven,29,29,0,0,0,09/18/2011,KIAA-Clusters
dandan,29,29,0,2,0,11/16/2011,AIfA-Cosmo
EG,29,29,0,0,8,12/07/2011,unaffiliated
adal,29,29,0,0,0,05/07/2012,PUC-Institute of Astrophysics
Sebastian,29,29,0,0,0,05/25/2012,Zürich
ndelee,29,29,0,0,0,09/06/2012,Vanderbilt
bwoshea,29,29,0,0,0,01/21/2013,Michigan State
jpw,29,29,0,0,0,02/03/2013,"IfA, University of Hawaii"
mbk,29,29,0,0,0,02/12/2013,University of Maryland
francehaa,29,29,0,0,0,04/04/2013,University of Milano-Bicocca
Flavia,29,29,0,0,0,04/08/2013,INAF-OAR
jmiralda,29,29,0,0,0,11/14/2013,ICCUB
bgaches,29,29,0,0,0,01/21/2014,UMass Amherst
lavaux,29,29,0,0,0,03/12/2014,IAP Cosmology and Extragalactic
Shangfei Liu,28,28,0,2,0,04/25/2010,UCSC
Anna,28,28,0,2,4,06/29/2010,UCSC
wenwen,28,28,0,0,0,09/15/2010,PKU
potatols,28,28,0,0,0,09/15/2010,DoA PKU
bob,28,28,0,0,0,09/15/2011,Rutgers
jellis11,28,28,0,0,0,09/16/2011,UW Milwaukee
maxham,28,28,0,0,0,03/07/2012,UNLV
YY,28,28,0,1,0,08/31/2012,Texas A&M
Simone,28,28,0,0,0,09/12/2012,U. Pittsburgh
andrew.cumming,28,28,0,0,0,09/18/2012,McGill
Mani Chandra,28,28,0,0,0,09/24/2012,UIUC
strader,28,28,0,0,0,12/04/2012,Michigan State
jsoishi,28,28,0,0,0,02/22/2013,AMNH
gcandlish,28,28,0,0,0,03/26/2013,"U. de Concepcion: Planetary, Stellar, Galactic, Extragalactic papers"
keV Wilk,28,28,0,0,0,05/24/2013,U. Pittsburgh
barbarab,28,28,0,0,0,10/03/2013,Osservatorio Astrofisico di Arcetri - Extragalactic
cheneka,28,28,0,0,0,03/12/2014,DARK
tdiamond,28,28,0,0,0,05/21/2014,FSU Astrophysics
DJacobs18,28,28,0,0,0,07/28/2014,UCT Cosmology
rb,28,28,0,0,0,09/25/2014,"U. of Sussex, Astronomy Centre"
Scott Griffiths,27,26,1,0,0,01/17/2014,University of Iowa
groorg1,27,27,0,0,0,08/01/2011,UT Austin
tdownes,27,27,0,0,0,08/19/2011,DIAS
keeton,27,27,0,0,0,09/13/2011,Rutgers
LVS,27,27,0,0,0,09/13/2011,MPA Garching
adrian,27,27,0,0,0,09/14/2011,Columbia
Matthias Gritschneder,27,27,0,0,2,10/24/2011,UCSC
claudia43,27,27,0,0,11,01/19/2012,unaffiliated
steph,27,27,0,0,0,03/21/2012,Yale
Feige Wang,27,27,0,1,0,07/19/2012,PKU
dragozzine,27,27,0,0,0,08/20/2012,University of Florida
pchela,27,27,0,0,0,10/23/2012,Durham University
VanessaLopezBarquero,27,27,0,1,0,01/17/2013,Universidad de Costa Rica
gistratta,27,27,0,0,0,01/26/2013,INAF-OAR
ebalsamo,27,27,0,0,0,02/14/2013,NASA Goddard Space Flight Center
Kenneth Chaves,27,27,0,0,0,04/06/2013,Universidad de Costa Rica
Nao Suzuki,27,27,0,4,0,09/19/2013,Kavli IPMU
Chris Boon,27,27,0,0,0,10/17/2013,University of Southampton
eladtan,27,27,0,0,0,11/20/2013,Hebrew University
Guldariya Nurbaeva,26,25,1,0,0,01/12/2012,EPFL - UniGe
iparrish,26,26,0,1,0,09/01/2010,UCB
rkotulla,26,26,0,0,0,11/15/2010,UW Milwaukee
zoltan haiman,26,26,0,0,0,01/31/2011,Columbia
Dan Coe,26,26,0,0,0,02/01/2011,STScI/JHU
alidz,26,26,0,0,0,05/23/2011,UPenn
lcashman,26,26,0,0,0,06/30/2011,Boston University
mlouie,26,26,0,0,0,09/28/2011,Stony Brook
apenin,26,26,0,0,0,01/18/2012,LAM
xms,26,26,0,1,0,04/18/2012,PKU
Hou Jun,26,26,0,2,0,04/24/2012,PKU
rmredd,26,26,0,0,0,08/21/2012,Stanford
teuben,26,26,0,2,0,10/12/2012,University of Maryland
drmadison,26,26,0,0,0,10/29/2012,Cornell
matteo.db,26,26,0,0,0,02/07/2013,INAF-OAR
rsmith,26,26,0,0,0,06/24/2013,CEA Saclay
owlice,26,26,0,0,0,08/01/2013,ASCL
abwalter,26,26,0,0,0,10/01/2013,UCSB
An,26,26,0,4,0,11/01/2013,PMO
avantyghem,26,26,0,0,0,11/22/2013,University of Waterloo
Steve Rodney,26,26,0,0,0,02/20/2014,Johns Hopkins
lschaefer,25,24,1,0,0,08/06/2012,Harvard ITC
Stephan,25,25,0,0,0,01/06/2011,Kapteyn-HI
nroth,25,25,0,0,0,06/17/2011,UCB
cgroppi,25,25,0,0,0,08/18/2011,ASU Astro
jdexter,25,25,0,0,0,09/06/2011,UCB
MilanS,25,25,0,0,0,10/13/2011,AOB
Peter,25,25,0,0,0,02/13/2012,CEA Saclay High Energy
Xiangkun Liu,25,25,0,0,0,04/13/2012,PKU
hamaus,25,25,0,0,0,05/30/2012,IAP Cosmology and Extragalactic
t_nithyanandan,25,25,0,0,0,06/05/2012,IISc-RRI
pkuwxb,25,25,0,0,0,07/20/2012,PKU
mmacgreg,25,25,0,0,0,08/06/2012,Harvard ITC
wenlong,25,25,0,1,0,08/28/2012,Texas A&M
tapauly,25,25,0,0,0,09/04/2012,Cornell
deatrick,25,25,0,1,3,09/10/2012,CEA Saclay High Energy
michaelliu,25,25,0,0,0,09/19/2012,"IfA, University of Hawaii"
Jessica Donaldson,25,25,0,0,0,10/16/2012,University of Maryland
Wynn Ho,25,25,0,0,0,10/24/2012,University of Southampton
loicmaurin,25,25,0,0,0,01/09/2013,APC
bart,25,25,0,0,0,04/10/2013,LJMU
beatriz,25,25,0,0,0,05/17/2013,UFRJ
nell,25,25,0,0,0,05/24/2013,University of Washington
hmessias,25,25,0,0,0,07/11/2013,"U. de Concepcion: Planetary, Stellar, Galactic, Extragalactic papers"
mubdi,25,25,0,0,0,10/10/2013,Johns Hopkins
Nigel Mathes,25,25,0,0,0,11/05/2013,NMSU
Stefano Cristiani,25,25,0,0,0,01/10/2014,OATS
jakemccoy,25,25,0,0,0,01/16/2014,University of Iowa
Rebecca Bowers,25,25,0,0,0,02/07/2014,Lehigh University
Jean Coupon,25,25,0,0,0,04/14/2014,EPFL - UniGe
fdeugenio,25,25,0,0,0,06/04/2014,Oxford University - Galaxies
ajaskot,25,25,0,0,0,09/03/2014,UMass Amherst
PawelB,25,25,0,0,0,10/03/2014,ICS
Judy,24,24,0,2,1,03/30/2010,UCSC
xueli,24,24,0,0,0,07/01/2010,DARK
Sijing Shen,24,24,0,2,3,10/06/2010,UCSC
sp_courty,24,24,0,0,0,09/08/2011,CRAL
imomcheva,24,24,0,0,0,02/01/2012,Unaffiliated
ben moore,24,24,0,0,0,05/27/2012,Zürich
mshabram,24,24,0,0,0,08/09/2012,Penn State
Louis Strigari,24,24,0,0,0,09/28/2012,Texas A&M
igr,24,24,0,0,0,10/11/2012,Edinburgh
JoaoFerreira,24,24,0,0,0,10/11/2012,Edinburgh
mburke,24,24,0,0,0,11/22/2012,University of Birmingham
Alex Deibel,24,24,0,0,0,02/12/2013,MSU Compact Objects
willhartley,24,24,0,0,0,05/13/2013,ETH-Extragalactic
cmurray,24,24,0,0,0,09/13/2013,UW Madison
rsadoun,24,24,0,0,0,12/16/2013,University of Utah
gbryan,23,23,0,0,0,09/08/2010,Columbia
destry,23,23,0,0,0,10/17/2010,Columbia
friedman,23,23,0,2,0,11/14/2010,UW Milwaukee
bac29,23,23,0,0,0,02/15/2011,UofT
mstalevski,23,23,0,2,0,09/16/2011,AOB
npirzkal,23,23,0,0,0,09/21/2011,STScI/JHU
scarlata_claudia,23,23,0,0,0,12/05/2011,UMN
JpKneib,23,23,0,0,0,01/27/2012,EPFL - UniGe
zz,23,23,0,0,0,04/18/2012,STScI/JHU
kristinapunzi,23,23,0,0,0,09/07/2012,RIT
rhc,23,23,0,0,0,10/18/2012,University of Maryland
Giulio Fabbian,23,23,0,0,0,01/21/2013,SISSA
kartik,23,23,0,3,0,02/04/2013,NRAO Charlottesville
RickyN,23,23,0,0,0,02/11/2013,AMNH
niemack,23,23,0,0,0,03/13/2013,Cornell-Cosmo
StewArd,23,23,0,0,0,04/19/2013,Arizona
dsullivan,23,23,0,0,0,09/18/2013,"U. of Sussex, Astronomy Centre"
andrewmcleod,23,23,0,0,0,10/14/2013,University of Exeter
rosst,23,23,0,0,0,11/12/2013,NMSU
ignotur,23,23,0,0,0,11/20/2013,Radboud University Nijmegen
trmillertr,23,23,0,0,0,01/16/2014,University of Oklahoma
Min Yun,23,23,0,0,0,01/22/2014,UMass Amherst
viogp,23,23,0,0,0,01/23/2014,Durham University
mamd,23,23,0,0,0,09/25/2014,IAS Orsay - ISM
darach,22,20,2,0,1,07/01/2010,DARK
jpeek,22,21,1,0,0,09/29/2010,Columbia
Marius Cautun,22,22,0,0,0,01/07/2011,Kapteyn
jascenso,22,22,0,0,0,03/11/2011,ESO Garching
S_Ilic,22,22,0,0,0,04/19/2011,IAS Orsay
piyanat,22,22,0,0,0,08/29/2011,ASU Astro
Francois Rerat,22,22,0,0,0,01/19/2012,EPFL - UniGe
jsilverman,22,22,0,0,0,03/28/2012,Kavli IPMU
lwoolsey,22,22,0,1,0,08/06/2012,Harvard ITC
Hui Sun,22,22,0,1,0,09/14/2012,UNLV
koss,22,22,0,0,0,09/18/2012,Zürich
brryan,22,22,0,0,0,10/08/2012,UIUC
governato,22,22,0,0,0,10/10/2012,University of Washington
Teo,22,22,0,1,0,11/08/2012,University of Southampton
Alexis,22,22,0,0,0,01/10/2013,APC
Alex McCormick,22,22,0,0,0,01/16/2013,University of Maryland
cmcasey,22,22,0,0,0,04/01/2013,UCI
Gwen,22,22,0,0,0,08/12/2013,Carnegie
anitazanella,22,22,0,0,0,09/19/2013,CEA Saclay
JensJH,22,22,0,0,0,11/05/2013,SAC
ramain,22,22,0,0,0,11/22/2013,University of Waterloo
Bob_Poltis,22,22,0,0,0,08/04/2014,UCT Cosmology
bodemory,22,22,0,0,0,09/10/2014,Exoplanets@Cambridge
Johannes Lange,22,22,0,0,0,09/15/2014,Yale
mcgrath,21,21,0,0,3,08/05/2009,UCSC
Fabio,21,21,0,0,1,10/06/2009,ICN-UNAM
tamarastro,21,21,0,0,0,07/01/2010,UQ
gert,21,21,0,0,0,01/07/2011,Kapteyn
Nora,21,21,0,0,0,03/18/2011,ESO Garching
whwang,21,21,0,0,0,03/23/2011,ASIAA
jordanstone,21,21,0,0,0,05/02/2011,Arizona
jdurrive,21,21,0,0,0,06/14/2011,IAS Orsay
jeremymurphy,21,21,0,0,0,08/19/2011,UT Austin
natta,21,21,0,0,0,08/25/2011,DIAS
bjames,21,21,0,0,0,09/15/2011,STScI/JHU
Guangtun,21,21,0,0,0,09/23/2011,STScI/JHU
lnigra,21,21,0,1,0,08/24/2012,Adler Planetarium
langmm,21,21,0,0,0,09/05/2012,Vanderbilt
jrad,21,21,0,0,0,10/24/2012,University of Washington
akravtsov,21,21,0,1,0,11/16/2012,Chicago-KICP
mroman,21,21,0,0,0,01/21/2013,APC
ripamonti.e@gmail.com,21,21,0,0,0,04/22/2013,University of Milano-Bicocca
Rob Olling,21,21,0,0,0,06/18/2013,University of Maryland
timothy,21,21,0,0,0,07/18/2013,UCI
Marja,21,21,0,0,0,09/10/2013,IAC
lstraka,21,21,0,0,0,09/18/2013,Chicago-KICP
aschulze,21,21,0,0,0,10/16/2013,Kavli IPMU
boutigny,21,21,0,0,0,10/25/2013,Stanford
kkuehn,21,21,0,0,0,11/04/2013,AAO
DeanneCoppejans,21,21,0,0,0,11/14/2013,Radboud University Nijmegen
mheida,21,21,0,0,0,11/19/2013,Radboud University Nijmegen
samuel,21,21,0,0,0,11/22/2013,LAM
hdesmond,21,21,0,0,0,01/11/2014,Stanford
SJTurnbull,21,21,0,0,0,01/24/2014,University of Waterloo
Sjoert,21,21,0,0,0,01/28/2014,Johns Hopkins
Isha,21,21,0,0,0,09/05/2014,IUCAA
b.fournier,21,21,0,0,0,10/01/2014,"U. of Sussex, Astronomy Centre"
Desiree Ferreira,20,20,0,0,0,06/28/2010,DARK
kvj,20,20,0,0,0,10/06/2010,Columbia
f.montanari,20,20,0,0,0,01/17/2011,Geneva Cosmology Group
lihwai,20,20,0,0,0,01/31/2011,ASIAA
tmeshkat,20,20,0,0,0,03/23/2011,Leiden
kevin.flaherty,20,20,0,0,0,04/19/2011,Arizona
pamigo,20,20,0,0,0,04/20/2011,PUC-Institute of Astrophysics
mdanowski,20,20,0,0,0,06/09/2011,Boston University
Rodolfo Santana,20,20,0,0,2,08/12/2011,UT Austin
emclinden,20,20,0,0,0,08/22/2011,UT Austin
manferna,20,20,0,5,0,09/15/2011,UIUC-SF
Keita,20,20,0,0,0,03/06/2012,UNLV
gaston,20,20,0,1,0,03/30/2012,IALP-FCAGLP
liubeibei,20,20,0,0,0,04/18/2012,PKU
Y.Zhang,20,20,0,0,0,09/10/2012,RIT
kaitlin.kratter,20,20,0,0,0,09/10/2012,Arizona
matilsky,20,20,0,0,0,11/08/2012,Rutgers
CRiseley,20,20,0,0,0,11/09/2012,University of Southampton
kstory,20,20,0,0,0,11/16/2012,Chicago-KICP
Marie Anne Bigot Sazy,20,20,0,0,0,01/10/2013,APC
husser,20,20,0,0,0,02/11/2013,UniGoettingen
a.kupper,20,20,0,0,0,04/02/2013,Yale
geespa,20,20,0,0,0,04/09/2013,LJMU
Daegene Koh,20,20,0,0,0,04/29/2013,Georgia Tech
flanusse,20,20,0,0,0,06/12/2013,CEA Saclay CosmoStat
dprice,20,20,0,0,0,08/15/2013,MoCA
laranava,20,20,0,0,0,11/19/2013,Hebrew University
arthurtsai,20,20,0,0,0,02/25/2014,NTHU
jlprieto,20,20,0,0,0,07/10/2014,UDP
Sebastian,20,20,0,1,0,11/14/2014,UCSB HEP/Gravity
kylepp,19,18,1,0,0,09/16/2010,Columbia
Rachel,19,19,0,0,3,08/31/2009,UCSC
Beth,19,19,0,0,0,04/05/2011,IAS Orsay
BTJ,19,19,0,0,0,04/18/2011,Arizona
diederik,19,19,0,0,0,08/03/2011,MPA Garching
rpatel272,19,19,0,0,0,09/08/2011,Stony Brook
Chengyuan Li,19,19,0,0,0,09/09/2011,unaffiliated
sanch,19,19,0,0,0,09/21/2011,STScI/JHU
Thiago,19,19,0,0,0,10/07/2011,Valongo Observatory
oollie,19,19,0,0,0,11/04/2011,University of Vienna
mikesmitka,19,19,0,0,0,11/18/2011,Texas A&M
yingjiepeng,19,19,0,1,0,11/28/2011,ETH-Extragalactic
matte,19,19,0,0,7,01/20/2012,unaffiliated
vperret,19,19,0,0,0,09/14/2012,ICS
jieun_choi,19,19,0,0,1,09/19/2012,UCSC
susmita,19,19,0,0,0,09/19/2012,UIUC
ncy,19,19,0,0,1,09/26/2012,McGill
Sam,19,19,0,0,0,10/18/2012,University of Southampton
Christopher Williams,19,19,0,0,0,11/16/2012,Stanford
tnatoli,19,19,0,0,0,11/16/2012,Chicago-KICP
tongyan,19,19,0,0,0,11/26/2012,Chicago-KICP
racine,19,19,0,1,0,01/10/2013,APC
SilviaPiran,19,19,0,0,0,02/01/2013,INAF-OAR
marassis,19,19,0,0,0,03/01/2013,INAF-OAR
annis,19,19,0,0,0,03/25/2013,Fermilab
dkleiner,19,19,0,0,0,07/29/2013,MoCA
bedding,19,19,0,0,0,08/22/2013,SIfA
caro.foster,19,19,0,0,0,10/17/2013,AAO
wands,19,19,0,0,0,10/29/2013,ICG Portsmouth
earanzana,19,19,0,0,0,11/27/2013,Radboud University Nijmegen
linc,19,19,0,0,0,02/24/2014,CEA Saclay CosmoStat
wisniewski,19,19,0,0,0,02/24/2014,University of Oklahoma
jdwood,19,19,0,0,0,04/14/2014,Clemson
s.dibi,19,19,0,0,0,06/19/2014,Radboud University Nijmegen
msl,19,19,0,0,0,08/20/2014,UCB cosmology
dida.markovic,19,19,0,0,0,10/16/2014,ICG Portsmouth
zacharygirazian,18,15,3,0,0,12/06/2013,Boston University
pdkiel,18,18,0,0,0,06/23/2010,CIERA
sitari_1,18,18,0,0,0,07/14/2010,University of Florida
christa,18,18,0,0,0,08/03/2010,DARK
kathryn_k,18,18,0,0,0,09/09/2010,unaffiliated
Regina,18,18,0,1,0,02/08/2011,U. Pittsburgh
dcarrasco,18,18,0,0,0,03/31/2011,PUC-Institute of Astrophysics
parriaga,18,18,0,0,0,04/20/2011,PUC-Institute of Astrophysics
npadilla,18,18,0,0,0,04/26/2011,PUC-Institute of Astrophysics
eeschneider,18,18,0,0,0,05/20/2011,Arizona
Matt Malloy,18,18,0,0,0,06/09/2011,UPenn
Valeria,18,18,0,0,0,02/15/2012,University of Heidelberg ITP/ITA
tolgaguver,18,18,0,0,0,03/21/2012,Sabanci University
....,18,18,0,0,0,10/18/2012,unaffiliated
Mario,18,18,0,0,0,11/09/2012,University of Chile-DFI
giallixx,18,18,0,0,0,01/28/2013,INAF-OAR
Christoph Federrath,18,18,0,0,0,01/30/2013,MoCA
nsehgal,18,18,0,0,0,02/19/2013,Stony Brook
Tom_Constantino,18,18,0,0,0,03/03/2013,MoCA
yksheen,18,18,0,0,0,03/22/2013,"U. de Concepcion: Planetary, Stellar, Galactic, Extragalactic papers"
liye,18,18,0,1,0,08/30/2013,UNLV
remo,18,18,0,0,0,09/03/2013,RSAA-ANU
Andrew Quick,18,18,0,0,0,09/20/2013,Texas A&M
Miguel Rocha,18,18,0,0,0,10/01/2013,UCI
pim,18,18,0,0,0,10/11/2013,Radboud University Nijmegen
jeenriquez,18,18,0,0,0,10/11/2013,Radboud University Nijmegen
fontanot,18,18,0,0,0,01/09/2014,OATS
etmeyer-stsci,18,18,0,0,0,01/16/2014,STScI-AGN
rhiannong123,18,18,0,0,0,01/17/2014,University of Oklahoma
gmcswain,18,18,0,0,0,02/07/2014,Lehigh University
robin,18,18,0,0,0,04/07/2014,RSAA-ANU
tkc004,18,18,0,0,0,07/29/2014,UCSD
decressin,17,17,0,0,0,07/09/2010,AIfA
hugh,17,17,0,0,0,09/15/2010,Columbia
Claire,17,17,0,0,0,12/05/2010,CEA Saclay
dparaficz,17,17,0,0,0,01/19/2011,LAM
Mark Neyrinck,17,17,0,0,0,02/01/2011,STScI/JHU
AnjaWeyant,17,17,0,0,0,02/21/2011,U. Pittsburgh
pteixeira,17,17,0,0,0,03/18/2011,University of Vienna
BrianM,17,17,0,0,0,08/19/2011,UT Austin
smoran,17,17,0,0,0,09/12/2011,STScI/JHU
vacquaviva,17,17,0,0,0,09/15/2011,AMNH
milena,17,17,0,0,0,09/16/2011,AOB
wmwv,17,17,0,0,0,10/11/2011,U. Pittsburgh
benelson,17,17,0,1,0,10/31/2011,Penn State
jctan,17,17,0,0,0,12/13/2011,University of Florida
kwhitaker,17,17,0,0,0,01/27/2012,NASA GSFC Extragalactic
Tanja,17,17,0,0,2,03/02/2012,Georgia Tech
Amit Vishwas,17,17,0,0,0,07/30/2012,Cornell
anja,17,17,0,0,0,08/07/2012,DARK
asgekar,17,17,0,1,0,08/24/2012,unaffiliated
bwibking,17,17,0,0,0,09/10/2012,Vanderbilt
mth,17,17,0,0,0,10/17/2012,University of Waterloo
dplant,17,17,0,0,0,10/18/2012,University of Southampton
erovilos,17,17,0,0,0,10/19/2012,NOA
Rob Firth,17,17,0,0,0,10/25/2012,University of Southampton
sallymac,17,17,0,0,0,11/19/2012,Radboud University Nijmegen
Kara Ponder,17,17,0,0,0,01/09/2013,U. Pittsburgh
paolotozzi,17,17,0,0,0,01/17/2013,Osservatorio Astrofisico di Arcetri - Extragalactic
paola.santini,17,17,0,0,0,01/25/2013,INAF-OAR
dober,17,17,0,0,0,02/07/2013,UPenn
Amaury Triaud,17,17,0,0,0,02/20/2013,MIT Exoplanet Tea
rarneson,17,17,0,0,0,02/21/2013,UMN
Song Huang,17,17,0,0,0,04/09/2013,Kavli IPMU
Michael,17,17,0,0,0,04/12/2013,ICS
ABDrake,17,17,0,0,0,04/19/2013,CRAL
timwaters,17,17,0,1,0,06/20/2013,UNLV
anewman,17,17,0,0,0,08/07/2013,Carnegie
Joe Callingham,17,17,0,0,3,08/22/2013,SIfA
luccas,17,17,0,0,0,08/25/2013,RSAA-ANU
fdeberna,17,17,0,0,0,09/03/2013,Cornell-Cosmo
Rook,17,17,0,0,0,09/16/2013,UW Madison
twhite,17,17,0,0,0,10/11/2013,UniGoettingen
tesplin,17,17,0,0,0,10/11/2013,Penn State
astrodsg,17,17,0,0,0,12/10/2013,University of Utah
starguy,17,17,0,2,0,01/10/2014,University of Iowa
yifat,17,17,0,0,0,09/10/2014,Weizmann Institute of Science
KwangHo Park,17,17,0,0,0,09/24/2014,Georgia Tech
JensKauffmann,17,17,0,0,0,10/30/2014,Unaffiliated
eleniv,17,17,0,0,0,11/11/2014,University of Crete
JonThaler,16,15,1,0,0,09/19/2012,UIUC
vmdelacita,16,15,1,0,0,10/23/2013,ICCUB
Katherine,16,16,0,0,2,07/26/2009,UCSC
colucci,16,16,0,0,3,12/01/2009,Carnegie
emoreno,16,16,0,0,0,07/12/2010,AIfA
aneta,16,16,0,0,0,09/27/2010,HEAD-CfA
rsmit,16,16,0,0,0,12/02/2010,Leiden
umetic,16,16,0,0,0,01/31/2011,ASIAA
hota,16,16,0,0,0,02/08/2011,ASIAA
slongmor,16,16,0,0,0,03/18/2011,ESO Garching
arojas,16,16,0,0,0,03/26/2011,PUC-Institute of Astrophysics
sydc,16,16,0,0,0,07/04/2011,UW Milwaukee
jardel,16,16,0,0,0,07/27/2011,UT Austin
Caroline,16,16,0,0,0,08/29/2011,Leiden
pdawson,16,16,0,0,0,08/30/2011,DIAS
lweiss,16,16,0,0,0,09/01/2011,UCB
nordlander,16,16,0,0,1,09/02/2011,Uppsala
diederik,16,16,0,0,0,09/13/2011,ESO Garching
Claudia,16,16,0,0,0,11/11/2011,University of Vienna
rskel,16,16,0,0,0,01/27/2012,Yale
rthompson,16,16,0,0,0,03/06/2012,UNLV
zhang,16,16,0,0,0,03/30/2012,UNLV
Aurel,16,16,0,0,0,05/25/2012,Zürich
simardg,16,16,0,0,0,09/18/2012,McGill
mca,16,16,0,0,0,09/19/2012,"IfA, University of Hawaii"
amrbarreira,16,16,0,0,0,10/17/2012,Durham University
irshad,16,16,0,0,0,10/18/2012,ICS
eshaya,16,16,0,0,0,10/18/2012,University of Maryland
bvulcani,16,16,0,0,0,10/19/2012,Kavli IPMU
lkreidberg,16,16,0,0,0,11/28/2012,Chicago-KICP
Phil Macias,16,16,0,0,1,12/10/2012,Harvard ITC
cec,16,16,0,0,0,04/10/2013,LJMU
miho,16,16,0,0,0,04/30/2013,Kavli IPMU
bnord,16,16,0,0,0,05/13/2013,Fermilab
jmontgom,16,16,0,0,0,06/10/2013,Boston University
ruizca,16,16,0,0,0,06/24/2013,unaffiliated
rafernan,16,16,0,0,0,08/02/2013,UCB
Sarah.L,16,16,0,0,0,08/24/2013,RSAA-ANU
martinbonielsen,16,16,0,0,0,09/26/2013,UniGoettingen
yzu,16,16,0,0,0,10/11/2013,Carnegie Mellon University
mteyssier,16,16,0,0,0,11/12/2013,Rutgers
Alan Duffy,16,16,0,0,0,02/10/2014,University of Melbourne
Alvaro Orsi,16,16,0,0,0,03/31/2014,CEFCA
croman,15,14,1,2,0,09/24/2013,IA-UNAM Ensenada
Bülent KIzILtan,15,15,0,4,2,08/19/2009,Harvard ITC
ilya,15,15,0,0,0,08/04/2010,University of Birmingham
ds,15,15,0,0,0,10/07/2010,Columbia
dawn,15,15,0,1,0,11/14/2010,UW Milwaukee
JohanComparat,15,15,0,0,0,01/17/2011,LAM
Jesper,15,15,0,0,0,01/27/2011,DARK
marcella,15,15,0,0,0,06/24/2011,ETH-Extragalactic
blaizot,15,15,0,0,0,09/01/2011,CRAL
ejullo,15,15,0,0,0,09/07/2011,LAM
Xiaoshuo,15,15,0,0,0,09/16/2011,unaffiliated
Emma,15,15,0,0,0,10/25/2011,UT Austin
kartik11,15,15,0,0,0,11/14/2011,NRAO Charlottesville
tjnelson,15,15,0,0,0,12/08/2011,UMN
Carito_V,15,15,0,0,0,05/03/2012,IATE
Charee Peters,15,15,0,0,0,05/30/2012,UW Madison
kevins,15,15,0,0,0,09/05/2012,ETH-Extragalactic
awl6964,15,15,0,0,0,09/10/2012,RIT
sehlert,15,15,0,0,0,09/11/2012,MIT
lxk,15,15,0,0,0,10/19/2012,Durham University
poetrysky,15,15,0,0,0,10/23/2012,PKU
wernernorbi,15,15,0,0,0,11/27/2012,Stanford
jtreguer,15,15,0,0,0,01/23/2013,APC
amanzotti,15,15,0,0,0,03/10/2013,Chicago-KICP
rdemarco,15,15,0,0,0,03/26/2013,"U. de Concepcion: Planetary, Stellar, Galactic, Extragalactic papers"
tagoreas,15,15,0,0,0,07/19/2013,Rutgers
Jared Rice,15,15,0,0,0,08/30/2013,UNLV
bmorsony,15,15,0,0,0,09/17/2013,UW Madison
smiller,15,15,0,0,0,10/03/2013,UCI
luriejcc,15,15,0,2,0,10/04/2013,University of Washington
Cameron Van Eck,15,15,0,1,0,10/14/2013,Radboud University Nijmegen
tdupuy,15,15,0,0,0,10/16/2013,UT Austin
Therese,15,15,0,0,0,10/17/2013,University of Southampton
hezaveh,15,15,0,0,0,10/28/2013,Stanford
vincent@phys.au.dk,15,15,0,0,0,11/09/2013,SAC
mrawls,15,15,0,0,0,11/11/2013,NMSU
avalcarc,15,15,0,0,0,01/20/2014,PUC-Institute of Astrophysics
ahsavage,15,15,0,0,0,01/22/2014,University of Iowa
Jon.Bartz,15,15,0,0,0,02/04/2014,Lehigh University
acthomas,15,15,0,0,0,03/26/2014,NTHU
abonanos,15,15,0,0,0,05/09/2014,NOA
VeraPatricio,15,15,0,0,0,06/28/2014,CRAL
Maciek,15,15,0,0,0,08/04/2014,UCT Cosmology
spalding,15,15,0,0,0,08/08/2014,Arizona
Patrick Wilcox,15,15,0,0,0,08/27/2014,University of Iowa
sjt,15,15,0,0,0,09/19/2014,Exoplanets@Cambridge
abshannon,15,15,0,0,0,09/22/2014,Exoplanets@Cambridge
Robert da Silva,14,14,0,0,3,08/14/2009,UCSC
loren,14,14,0,1,0,06/30/2010,CIERA
gstef,14,14,0,0,0,11/13/2010,UW Milwaukee
schapman,14,14,0,0,0,01/27/2011,ASIAA
Greg,14,14,0,0,0,02/09/2011,University of Melbourne
areisene,14,14,0,0,0,04/22/2011,PUC-Institute of Astrophysics
chrism,14,14,0,0,0,06/22/2011,ETH-Extragalactic
jer,14,14,0,0,0,08/11/2011,DARK
paul,14,14,0,0,0,08/23/2011,Penn State
phegel,14,14,0,0,0,08/25/2011,ASU Astro
jokirosdahl,14,14,0,0,0,08/29/2011,Leiden
julie,14,14,0,0,0,08/31/2011,UT Austin
vbailey,14,14,0,0,0,09/16/2011,Arizona
c_scarlata,14,14,0,0,0,09/22/2011,UMN
Anna Durkalec,14,14,0,0,0,11/09/2011,LAM
jtgiblin,14,14,0,0,2,01/31/2012,unaffiliated
Lavinia,14,14,0,0,3,02/07/2012,unaffiliated
kosack,14,14,0,0,0,02/13/2012,CEA Saclay High Energy
dcseh,14,14,0,0,0,02/13/2012,CEA Saclay High Energy
Jerome,14,14,0,0,0,02/16/2012,CEA Saclay High Energy
pbllambay,14,14,0,0,0,04/12/2012,IATE
arunima,14,14,0,0,0,04/19/2012,NCRA
aaronew,14,14,0,0,0,05/09/2012,MIT
lacy,14,14,0,0,0,05/16/2012,UT Austin
merritt,14,14,0,0,0,09/01/2012,RIT
sbenjamin,14,14,0,0,0,09/05/2012,Yale
masc,14,14,0,0,0,09/26/2012,"Oskar Klein Centre, Stockholm University"
Freeke,14,14,0,0,0,10/18/2012,UCB
jruan,14,14,0,0,0,10/24/2012,University of Washington
eroebber,14,14,0,0,0,11/29/2012,McGill
alexji,14,14,0,0,0,12/09/2012,MIT
tlan,14,14,0,0,0,01/17/2013,Johns Hopkins
iiajournalclub,14,14,0,0,0,01/24/2013,IIA
AlbertStebbins,14,14,0,0,0,02/28/2013,Fermilab
skent,14,14,0,0,4,03/20/2013,Fermilab
lias,14,14,0,0,0,03/25/2013,"U. de Concepcion: Planetary, Stellar, Galactic, Extragalactic papers"
imccarthy,14,14,0,0,0,04/12/2013,LJMU
JSchmitt,14,14,0,0,0,05/28/2013,Yale
Jake Crossett,14,14,0,0,0,07/29/2013,MoCA
Terrence Tricco,14,14,0,0,0,08/01/2013,MoCA
aaron.dotter,14,14,0,0,0,08/23/2013,RSAA-ANU
boywert,14,14,0,0,0,09/19/2013,"U. of Sussex, Astronomy Centre"
Carlo A.,14,14,0,3,0,10/11/2013,AIfA
xielizhi,14,14,0,0,0,12/02/2013,NAOC
cupani,14,14,0,0,0,01/09/2014,OATS
sara.d.barber,14,14,0,0,0,01/16/2014,University of Oklahoma
ydubois,14,14,0,0,0,03/12/2014,IAP Cosmology and Extragalactic
lusso,14,14,0,0,0,05/27/2014,Osservatorio Astrofisico di Arcetri - Extragalactic
bzackay,14,14,0,0,0,09/11/2014,Weizmann Institute of Science
Nicolas,14,14,0,0,0,11/12/2014,LAM
Enrico,13,12,1,0,0,09/08/2009,UCSC
ray,13,12,1,0,0,05/25/2012,Zürich
Clément,13,13,0,1,4,09/24/2009,UCSC
bfarr,13,13,0,0,0,06/30/2010,CIERA
drr0b,13,13,0,0,0,09/27/2010,HEAD-CfA
samskillman,13,13,0,0,0,11/04/2010,Stanford
lrigu,13,13,0,0,0,12/02/2010,CEA Saclay
demooij,13,13,0,0,0,12/08/2010,Leiden
kdenney,13,13,0,0,0,01/27/2011,DARK
Max B,13,13,0,0,0,02/25/2011,Swinburne
tds,13,13,0,0,0,07/08/2011,IISc-RRI
rjansen,13,13,0,0,0,08/11/2011,ASU Astro
bcarande,13,13,0,0,0,08/22/2011,ASU Astro
keely,13,13,0,0,0,08/23/2011,UT Austin
Ulrike,13,13,0,0,0,09/04/2011,Uppsala
mojur,13,13,0,0,0,09/16/2011,AOB
philchang,13,13,0,0,0,09/16/2011,UW Milwaukee
schaerer,13,13,0,0,0,01/17/2012,EPFL - UniGe
jaacksj,13,13,0,0,0,03/05/2012,UT Austin
stadel,13,13,0,1,0,05/30/2012,ICS
crazycarl42,13,13,0,0,0,08/20/2012,Cornell
jscargle,13,13,0,2,0,09/04/2012,Stanford
jstott,13,13,0,0,0,10/17/2012,Durham University
tomhassall,13,13,0,0,0,10/19/2012,University of Southampton
EricLagadec,13,13,0,0,0,10/29/2012,Cornell
arka,13,13,0,0,0,10/29/2012,UIUC
Aarran,13,13,0,0,0,11/01/2012,University of Southampton
dkrogsrud,13,13,0,0,0,11/08/2012,Gemini-South
aadamson_gemini,13,13,0,0,0,11/10/2012,Gemini-North
kassin,13,13,0,0,0,01/23/2013,STScI/JHU
slepine,13,13,0,0,0,02/25/2013,AMNH
rlynch,13,13,0,0,0,02/27/2013,McGill
rafaeleufrasio,13,13,0,0,0,08/27/2013,NASA GSFC Extragalactic
alwilliams,13,13,0,0,0,09/16/2013,UW Madison
rocco,13,13,0,0,0,11/04/2013,Radboud University Nijmegen
sbussmann,13,13,0,0,0,11/05/2013,Cornell
jcam,13,13,0,0,0,11/20/2013,ASIAA
pigi.monaco,13,13,0,0,0,01/13/2014,OATS
erin.m.cooper,13,13,0,0,0,01/23/2014,University of Oklahoma
amonteux,13,13,0,0,0,04/07/2014,UCSC-HEP
AdamRubin,13,13,0,0,0,09/10/2014,Weizmann Institute of Science
rd,13,13,0,0,0,09/14/2014,Harvard ITC
Eric Gentry,13,13,0,0,1,10/03/2014,UCSC
milchada,12,11,1,0,0,10/15/2014,Yale
Claire Max,12,12,0,0,0,09/08/2009,UCSC
mfduran,12,12,0,0,1,08/12/2010,UCSC
nchapman,12,12,0,0,0,09/30/2010,CIERA
rasimcoe,12,12,0,0,0,11/08/2010,MIT
dperley,12,12,0,0,0,01/20/2011,Caltech
lelli,12,12,0,0,0,01/20/2011,Kapteyn
wwilliams,12,12,0,0,0,01/21/2011,Leiden
Matt O.,12,12,0,0,0,02/24/2011,AAO
rachelpm,12,12,0,1,0,06/10/2011,Boston University
amrejd,12,12,0,0,0,09/15/2011,Rutgers
jpwalker,12,12,0,0,0,09/16/2011,Rutgers
fzi,12,12,0,0,0,11/03/2011,University of Vienna
da-mayer,12,12,0,0,0,11/06/2011,University of Vienna
Armin,12,12,0,0,5,11/07/2011,University of Vienna
dcastro,12,12,0,0,0,11/23/2011,MIT
tiret,12,12,0,0,0,01/12/2012,EPFL - UniGe
mirkadessauges,12,12,0,0,0,01/12/2012,EPFL - UniGe
janagrc,12,12,0,0,0,01/22/2012,AMNH
deng,12,12,0,0,0,03/09/2012,UNLV
S,12,12,0,0,0,04/03/2012,STScI/JHU
Xiaochen Zheng,12,12,0,0,0,04/22/2012,PKU
donninoa,12,12,0,0,0,05/25/2012,Zürich
crumleyp,12,12,0,1,3,05/30/2012,UT Austin
Joshua Pepper,12,12,0,0,0,09/05/2012,Vanderbilt
Dmitry,12,12,0,0,0,09/06/2012,Stanford
roodman,12,12,0,0,0,09/07/2012,Stanford
marcio,12,12,0,0,0,10/18/2012,University of Maryland
Herbert Lau,12,12,0,0,0,10/23/2012,AIfA
g.a.palma,12,12,0,0,0,11/18/2012,University of Chile-DFI
mstalevski_ugent,12,12,0,0,0,11/22/2012,Ghent University
chaster,12,12,0,0,0,11/28/2012,University of Birmingham
kevincovey,12,12,0,0,0,12/08/2012,Lowell Observatory
apeter,12,12,0,1,0,02/05/2013,UCI
mordecai,12,12,0,0,0,02/12/2013,AMNH
Tiago Castro,12,12,0,0,0,05/23/2013,UFRJ
itho,12,12,0,0,0,07/15/2013,"IfA, University of Hawaii"
natlampe,12,12,0,0,1,07/29/2013,MoCA
kel,12,12,0,0,0,07/29/2013,"IfA, University of Hawaii"
PaulHancock,12,12,0,5,0,08/22/2013,SIfA
jwurster,12,12,0,0,0,09/24/2013,MoCA
mrline,12,12,0,0,2,09/27/2013,UCSC
dbarron,12,12,0,0,0,09/30/2013,UCSD
Clement,12,12,0,0,0,10/08/2013,IAS Orsay
zgy0106,12,12,0,0,0,10/10/2013,Nanjing University
cwolf,12,12,0,0,0,10/21/2013,RSAA-ANU
gaoyuxiang,12,12,0,1,0,11/01/2013,PMO
abigailstevens,12,12,0,0,0,11/05/2013,University of Amsterdam
ZhiyuZhang,12,12,0,0,0,11/05/2013,PMO
silentrash,12,12,0,0,0,01/04/2014,UMass Amherst
molaro,12,12,0,0,0,01/11/2014,OATS
Ken Gayley,12,12,0,1,0,01/29/2014,University of Iowa
jshelton,12,12,0,0,0,01/30/2014,UIUC
Pangel,12,12,0,0,0,02/10/2014,University of Melbourne
kata,12,12,0,0,0,02/13/2014,University of Melbourne
zouyc,12,12,0,0,0,03/04/2014,HUST astro
muzzinad,12,12,0,0,0,03/18/2014,Leiden
soffner,12,12,0,0,0,07/28/2014,UMass Amherst
peeter,12,12,0,0,0,11/13/2014,Tartu Obs
Rain,12,12,0,0,0,11/17/2014,Tartu Obs
carlosfb,12,12,0,0,0,12/01/2014,IALP-FCAGLP
dwroc,11,10,1,0,0,09/15/2010,PKU
Ivancic_Tim,11,10,1,0,0,11/21/2011,unaffiliated
Aaron Romanowsky,11,11,0,1,10,07/30/2009,UCSC
cdorman,11,11,0,0,2,09/22/2010,UCSC
GilesNovak,11,11,0,0,0,09/23/2010,CIERA
jhidding,11,11,0,0,0,11/22/2010,Kapteyn
jwg,11,11,0,0,0,01/04/2011,Columbia
mikhailway,11,11,0,1,0,02/10/2011,Columbia
abosma,11,11,0,0,0,02/24/2011,LAM
flacasa,11,11,0,0,0,04/14/2011,IAS Orsay
djacobs,11,11,0,0,0,05/24/2011,ASU Astro
alh,11,11,0,0,0,07/25/2011,UT Austin
kfkaplan,11,11,0,0,0,08/19/2011,UT Austin
jrgauthier,11,11,0,0,0,11/03/2011,Caltech
eli,11,11,0,0,0,04/26/2012,IATE
jspilker,11,11,0,0,0,05/09/2012,Arizona
jsimon,11,11,0,0,0,10/03/2012,Carnegie
Tom Crawford,11,11,0,0,1,10/04/2012,UT Austin
hjan,11,11,0,0,0,10/05/2012,McGill
adanielson,11,11,0,0,0,10/17/2012,Durham University
smargheim,11,11,0,0,0,10/22/2012,Gemini-South
Hakim,11,11,0,0,0,11/14/2012,EPFL - UniGe
lpei,11,11,0,0,0,01/24/2013,UCI
Elwin Martin,11,11,0,0,0,01/29/2013,Georgia Tech
tabby,11,11,0,0,0,05/03/2013,Yale-Planets
jamunoz,11,11,0,0,0,06/19/2013,UCSB
djbs,11,11,0,0,0,07/05/2013,University of Hertfordshire
Dong,11,11,0,0,0,07/13/2013,DARK
hworpel,11,11,0,0,0,07/28/2013,MoCA
lyalcorn,11,11,0,0,0,08/28/2013,Texas A&M
Justin Bray,11,11,0,0,0,09/04/2013,University of Southampton
sandersdbs,11,11,0,0,0,09/19/2013,"IfA, University of Hawaii"
lspitler,11,11,0,0,0,10/10/2013,AAO
ChrisFro,11,11,0,0,0,10/16/2013,University of Southampton
lluis mas,11,11,0,0,0,10/24/2013,ICCUB
jogler,11,11,0,0,0,10/31/2013,Stanford
nobuhiro.okabe,11,11,0,0,0,11/01/2013,Kavli IPMU
ajvdhorst,11,11,0,0,0,11/05/2013,University of Amsterdam
karinsandstrom,11,11,0,0,0,11/06/2013,Arizona
nafshordi,11,11,0,0,1,11/27/2013,University of Waterloo
tdecressin,11,11,0,0,0,01/10/2014,INAF-OAR
jcarrick,11,11,0,0,0,01/16/2014,University of Waterloo
mraveri,11,11,0,0,0,01/28/2014,SISSA
Jonathan Cornell,11,11,0,0,0,02/28/2014,UCSC-HEP
BehnamDarvish,11,11,0,0,0,09/18/2014,UCR
rob.izzard,10,10,0,0,0,07/27/2010,AIfA
nballering,10,10,0,0,0,04/19/2011,Arizona
ElvisWeiHao,10,10,0,0,0,09/19/2011,unaffiliated
Denise R Goncalves,10,10,0,2,0,10/13/2011,Valongo Observatory
kmd,10,10,0,0,0,10/13/2011,Valongo Observatory
nsuntzeff,10,10,0,0,0,11/18/2011,Texas A&M
chaty,10,10,0,0,0,02/10/2012,CEA Saclay High Energy
Yan,10,10,0,0,0,03/30/2012,Kavli IPMU
olefevre,10,10,0,0,0,04/17/2012,LAM
zboero,10,10,0,0,0,06/01/2012,IATE
itaboada,10,10,0,0,0,06/29/2012,Georgia Tech
juliehl,10,10,0,0,0,09/06/2012,Stanford
Lucas Macri,10,10,0,0,0,09/07/2012,Texas A&M
Matias,10,10,0,0,0,09/21/2012,UIUC
bick,10,10,0,0,0,10/05/2012,Kavli IPMU
mstrader,10,10,0,0,0,10/18/2012,UCSB
Anthony Rushton,10,10,0,0,0,10/25/2012,University of Southampton
Thomas_TT,10,10,0,0,0,01/22/2013,APC
Pierre Guillard,10,10,0,0,0,01/25/2013,IAP Cosmology and Extragalactic
ulfon,10,10,0,0,0,02/18/2013,UniGoettingen
giova,10,10,0,0,0,02/25/2013,Osservatorio Astrofisico di Arcetri - Extragalactic
lshishkov,10,10,0,0,0,08/26/2013,Michigan State
Ricky,10,10,0,0,0,09/09/2013,UIUC
rmandelb,10,10,0,0,0,09/23/2013,Carnegie Mellon University
tofflemire,10,10,0,0,0,09/25/2013,UW Madison
Laura Sales,10,10,0,0,0,10/18/2013,Harvard ITC
Antonio Cava,10,10,0,0,0,11/18/2013,EPFL - UniGe
otelford,10,10,0,0,0,11/22/2013,University of Washington
iii,10,10,0,0,0,01/03/2014,University of Utah
guoh,10,10,0,0,0,01/14/2014,University of Utah
etmeyer,10,10,0,0,0,01/15/2014,Johns Hopkins
albert,10,10,0,0,0,01/20/2014,Yale-LSS
mongardi,10,10,0,0,0,01/22/2014,OATS
sdanieli,10,10,0,0,0,01/26/2014,Yale-LSS
daniela carrasco,10,10,0,0,0,02/13/2014,University of Melbourne
wara,10,10,0,0,0,03/09/2014,UniGoettingen
awhoward,10,10,0,0,0,03/13/2014,"IfA, University of Hawaii"
doddy,10,10,0,0,0,03/20/2014,Perimeter Institute for Theoretical Physics
mayuri.s.rao,10,10,0,0,0,05/05/2014,RSAA-ANU
pmv,10,10,0,0,0,09/10/2014,Weizmann Institute of Science
Steven Duivenvoorden,10,10,0,0,0,09/26/2014,"U. of Sussex, Astronomy Centre"
pauldragulin,10,10,0,0,0,09/30/2014,FSU Astrophysics
yuyenchang,10,10,0,0,0,10/06/2014,CEA Saclay
rpverbek,10,10,0,0,0,10/21/2014,Ghent University
jestout,10,10,0,0,0,11/04/2014,Cornell LEPP-STRINGS
antti,10,10,0,0,0,11/10/2014,Tartu Obs
fkm,10,10,0,0,0,11/20/2014,Exoplanets@Cambridge
Dale Kocevski,9,9,0,0,0,10/07/2009,UCSC
Jerome,9,9,0,0,7,09/18/2010,UCSC
jwerk,9,9,0,0,3,10/19/2010,UCSC
atish,9,9,0,1,0,11/15/2010,UW Milwaukee
yoram,9,9,0,0,0,12/02/2010,CIERA
sunny,9,9,0,0,0,02/03/2011,ASIAA
cmy,9,9,0,0,0,02/08/2011,ASIAA
florent,9,9,0,0,0,02/14/2011,CEA Saclay
deustua,9,9,0,0,0,03/18/2011,STScI/JHU
Behrang,9,9,0,0,0,03/30/2011,ESO Garching
Yong ZHENG,9,9,0,0,0,09/08/2011,unaffiliated
709a,9,9,0,0,0,09/22/2011,NAOC
asgr,9,9,0,0,0,10/14/2011,ICRAR
zahra,9,9,0,0,0,11/14/2011,AIfA-Cosmo
rayalucas,9,9,0,0,0,11/16/2011,STScI/JHU
Romaine Theler,9,9,0,0,0,01/12/2012,EPFL - UniGe
blundgr2,9,9,0,0,0,02/01/2012,Yale
acoleiro,9,9,0,0,0,02/10/2012,CEA Saclay High Energy
masayuki tanaka,9,9,0,0,0,03/30/2012,Kavli IPMU
melina,9,9,0,0,0,04/04/2012,Kavli IPMU
congyao zhang,9,9,0,0,0,04/18/2012,PKU
khamren,9,9,0,0,4,05/02/2012,UCSC
tamarab,9,9,0,0,0,05/03/2012,Georgia Tech
Jonathan,9,9,0,0,0,05/25/2012,Zürich
andreas,9,9,0,0,0,05/25/2012,ICS
zhhrun,9,9,0,0,0,06/13/2012,PKU
jyoo,9,9,0,0,0,07/04/2012,ICS
AdamH,9,9,0,0,0,08/07/2012,University of Southampton
Greg Madejski,9,9,0,0,0,09/06/2012,Stanford
funk,9,9,0,0,0,09/07/2012,Stanford
Tom Abel,9,9,0,0,0,09/11/2012,Stanford
hyshan,9,9,0,0,0,09/17/2012,EPFL - UniGe
johannjc,9,9,0,0,0,09/19/2012,University of Rochester
Erica Kaminski,9,9,0,0,0,09/21/2012,University of Rochester
alekseygenerozov,9,9,0,0,0,09/28/2012,Columbia
Luke,9,9,0,0,0,09/28/2012,Cornell
hughbg,9,9,0,0,0,10/12/2012,CEA Saclay High Energy
snv,9,9,0,0,0,10/15/2012,University of Maryland
Ben Lowing,9,9,0,0,0,10/17/2012,Durham University
debashis,9,9,0,0,0,10/23/2012,AIfA
anoble,9,9,0,0,0,11/02/2012,McGill
ppessev,9,9,0,0,0,11/21/2012,Gemini-South
shichao,9,9,0,0,0,11/30/2012,Georgia Tech
megan,9,9,0,0,0,12/11/2012,Michigan State
Lauren Anderson,9,9,0,0,0,01/04/2013,University of Washington
nina,9,9,0,0,0,01/17/2013,McGill
banyal,9,9,0,0,0,02/20/2013,UniGoettingen
Lorenzo,9,9,0,0,0,03/21/2013,Zürich
ccombs,9,9,0,0,0,05/28/2013,Yale-Planets
ameliafm,9,9,0,0,0,08/15/2013,MoCA
Abhi,9,9,0,0,0,10/02/2013,ASU Astro
tullio,9,9,0,0,1,10/15/2013,University of Amsterdam
jberrier,9,9,0,1,0,11/08/2013,Rutgers
paz.beniamini,9,9,0,0,0,11/19/2013,Hebrew University
twevers,9,9,0,0,0,11/29/2013,Radboud University Nijmegen
rodrigje,9,9,0,0,0,01/14/2014,Vanderbilt
nedwright,9,9,0,0,0,01/17/2014,Johns Hopkins
nbutterfield,9,9,0,0,0,01/21/2014,University of Iowa
atmichael,9,9,0,0,0,01/21/2014,Boston University
daludovici,9,9,0,0,0,01/23/2014,University of Iowa
fpaci,9,9,0,0,0,01/27/2014,SISSA
Tingting Liu,9,9,0,0,0,02/06/2014,University of Maryland
jaehongp,9,9,0,0,0,03/07/2014,University of Melbourne
tbeatty,9,9,0,0,0,03/20/2014,OSU Astronomy
tsuarez,9,9,0,0,0,03/31/2014,UCL Extragalactic Journal Club
el,9,9,0,0,0,08/21/2014,UCB cosmology
shahmed,9,9,0,0,0,09/01/2014,Rutgers
anchwr,9,9,0,0,0,09/02/2014,Rutgers
Olcayplevne,9,9,0,0,0,09/29/2014,Istanbul University
mlmc,9,9,0,0,0,10/03/2014,Yale
creinh,9,9,0,0,0,10/17/2014,ICS
lloydronning,9,9,0,0,0,10/23/2014,LANL
josephsmidt,9,9,0,0,0,10/23/2014,LANL
lfrey,9,9,0,0,0,10/23/2014,LANL
bsipocz,9,9,0,0,0,10/29/2014,Exoplanets@Cambridge
enricopiconcelli,8,6,2,0,0,01/25/2013,INAF-OAR
Nathaniel Stickley,8,7,1,0,0,04/20/2011,UCR
hneilson,8,8,0,0,0,07/06/2010,unaffiliated
cenko,8,8,0,0,0,08/26/2010,University of Maryland
jia,8,8,0,0,0,09/14/2010,Columbia
jenna,8,8,0,0,0,09/16/2010,Columbia
amiller,8,8,0,0,0,02/02/2011,UCB
nikkolazo,8,8,0,0,0,04/20/2011,PUC-Institute of Astrophysics
clampitt,8,8,0,0,0,05/20/2011,UPenn
Pierre,8,8,0,0,0,05/31/2011,CEA Saclay
mmsong,8,8,0,0,0,07/18/2011,UT Austin
ckilpatrick,8,8,0,0,0,07/22/2011,Arizona
sarabladh,8,8,0,0,0,08/10/2011,Uppsala
christensen,8,8,0,0,0,10/07/2011,Arizona
giovanna.zanardo,8,8,0,0,0,10/14/2011,ICRAR
astroe,8,8,0,0,0,10/14/2011,Leiden
marco.velliscig,8,8,0,0,0,11/28/2011,Leiden-NOLG
katelynallers,8,8,0,0,0,02/08/2012,UT Austin
rfjvanderburg,8,8,0,0,0,02/13/2012,CEA Saclay
lukas.hollenstein,8,8,0,0,0,02/17/2012,Geneva Cosmology Group
lhj,8,8,0,0,0,03/22/2012,UNLV
JohnBoisvert,8,8,0,0,0,03/29/2012,UNLV
heli,8,8,0,0,0,04/12/2012,IATE
jsilv,8,8,0,0,0,04/16/2012,UT Austin
GRBLee,8,8,0,0,0,04/18/2012,PKU
Sebastiano,8,8,0,0,2,05/22/2012,UCSC
felix,8,8,0,0,0,05/30/2012,Zürich
shadden,8,8,0,0,0,06/11/2012,CIERA
amortazavi,8,8,0,0,0,06/13/2012,STScI/JHU
Daria Kosenko,8,8,0,0,0,06/27/2012,CEA Saclay High Energy
svobodb,8,8,0,0,0,08/10/2012,Arizona
yshirley,8,8,0,0,0,08/24/2012,Arizona
ChristineT,8,8,0,0,0,09/02/2012,RIT
ilanam,8,8,0,0,0,10/16/2012,UofT
cwfinn,8,8,0,0,0,10/17/2012,Durham University
bizard,8,8,0,0,0,10/17/2012,Yale-Planets
Christian Knigge,8,8,0,0,0,10/18/2012,University of Southampton
ChrisReynolds,8,8,0,0,0,11/16/2012,University of Maryland
Vasily Belokurov,8,8,0,0,0,01/09/2013,Cambridge
perutaca,8,8,0,0,0,01/16/2013,unaffiliated
ctchen,8,8,0,0,0,01/21/2013,Dartmouth College
Ed B,8,8,0,0,0,01/22/2013,Michigan State
angela.bongiorno,8,8,0,0,0,01/25/2013,INAF-OAR
schuh,8,8,0,0,0,01/31/2013,UniGoettingen
jsanchezvalle,8,8,0,0,0,02/12/2013,Universidad de Costa Rica
orgraur,8,8,0,0,0,02/21/2013,AMNH
bbowler,8,8,0,1,0,02/21/2013,"IfA, University of Hawaii"
Joaquin,8,8,0,0,0,03/14/2013,UIUC
davidefiacconi,8,8,0,0,0,04/02/2013,ICS
jcmoriar,8,8,0,0,0,05/01/2013,Yale-Planets
Márcio O'Dwyer,8,8,0,0,0,05/23/2013,UFRJ
neilcook,8,8,0,0,0,06/18/2013,University of Hertfordshire
jgeach,8,8,0,0,0,06/21/2013,University of Hertfordshire
gulay,8,8,0,0,0,07/24/2013,University of Hertfordshire
mlugaro,8,8,0,0,0,07/29/2013,MoCA
tdolley,8,8,0,0,0,08/01/2013,MoCA
dburlon,8,8,0,0,0,08/22/2013,SIfA
bard,8,8,0,0,0,09/16/2013,UW Madison
GailZasowski,8,8,0,0,0,10/10/2013,Johns Hopkins
paultheastronomer,8,8,0,0,0,10/14/2013,University of Exeter
tdelubac,8,8,0,0,0,10/18/2013,EPFL - UniGe
jfaherty,8,8,0,0,0,11/04/2013,Carnegie
kuckert,8,8,0,0,2,11/08/2013,NMSU
Chih-Fan Chen,8,8,0,0,0,11/11/2013,ASIAA
mrhayden,8,8,0,0,0,11/12/2013,NMSU
rmutel,8,8,0,0,0,01/16/2014,University of Iowa
Danka Paraficz,8,8,0,0,0,01/23/2014,EPFL - UniGe
rjharris,8,8,0,0,0,01/23/2014,UIUC-SF
andersld,8,8,0,0,0,01/27/2014,WVU
vdhulst,8,8,0,0,0,02/02/2014,Kapteyn-HI
dtamayo,8,8,0,0,0,02/03/2014,Cornell
bboizell,8,8,0,0,0,02/04/2014,UCI
stefano.ansoldi,8,8,0,0,0,03/10/2014,SISSA
julianmejia,8,8,0,0,0,03/23/2014,UChile - Calan
Philip.Bruen,8,8,0,0,0,04/06/2014,RSAA-ANU
alporte,8,8,0,0,0,04/14/2014,Clemson
mireland,8,8,0,0,0,05/12/2014,RSAA-ANU
bfuzia,8,8,0,0,0,05/19/2014,FSU Astrophysics
Katarina Kovac,8,8,0,0,0,07/11/2014,ETH-Extragalactic
Katherina,8,8,0,0,1,09/23/2014,UCSC
yosefz,8,8,0,0,0,10/02/2014,RIT-CCRG
Vincent Vennin,8,8,0,0,0,10/21/2014,ICG Portsmouth
Xiangcheng Ma,8,8,0,0,0,11/03/2014,Caltech
hendrik,8,8,0,0,0,11/05/2014,AIfA-Cosmo
thisiscody,8,8,0,0,0,11/06/2014,Cornell LEPP-STRINGS
Vanderveld,7,6,1,0,0,11/16/2012,Chicago-KICP
crosby,7,6,1,0,0,01/15/2013,Michigan State
Rebecca,7,7,0,0,0,09/04/2009,UCSC
Bhargav,7,7,0,0,0,04/13/2010,UCSC
jon,7,7,0,0,0,07/09/2010,AIfA
andrew.kruger,7,7,0,0,0,09/23/2010,CIERA
jfwang,7,7,0,0,0,09/27/2010,CIERA
mrose87,7,7,0,0,0,01/21/2011,Leiden
annalisa.pillepich,7,7,0,1,7,02/07/2011,Harvard ITC
peiying,7,7,0,0,0,02/16/2011,ASIAA
djmatthews,7,7,0,0,0,02/17/2011,U. Pittsburgh
pjensen,7,7,0,0,0,02/24/2011,Swinburne
jalonso,7,7,0,0,0,04/20/2011,PUC-Institute of Astrophysics
Matthieu,7,7,0,0,0,05/11/2011,IAS Orsay
smoats,7,7,0,0,0,05/17/2011,Arizona
psalas,7,7,0,0,0,05/18/2011,PUC-Institute of Astrophysics
ctstahl,7,7,0,0,0,06/14/2011,IAS Orsay
pipinoa,7,7,0,0,0,06/23/2011,ETH-Extragalactic
ecameron,7,7,0,1,0,06/24/2011,unaffiliated
csalyk,7,7,0,0,0,07/26/2011,Arizona
masha,7,7,0,0,0,08/23/2011,DIAS
somad,7,7,0,0,0,08/29/2011,ASU Astro
Pawel,7,7,0,0,0,09/07/2011,ETH-Extragalactic
cetus,7,7,0,0,0,09/08/2011,unaffiliated
Jingjing,7,7,0,0,0,09/08/2011,unaffiliated
stardoctor,7,7,0,0,0,09/12/2011,STScI/JHU
long,7,7,0,0,0,09/12/2011,STScI/JHU
lhovey,7,7,0,0,0,09/14/2011,Rutgers
Rodolfo Navarrete Perez,7,7,0,0,16,09/29/2011,UCSC
elena.b,7,7,0,0,0,10/05/2011,ETH-Extragalactic
mn,7,7,0,0,0,10/08/2011,ASIAA
mehmet,7,7,0,0,0,10/19/2011,ICRAR
JosefH,7,7,0,0,0,11/18/2011,University of Vienna
Doug,7,7,0,0,0,02/01/2012,Chicago-KICP
Larne,7,7,0,0,0,03/09/2012,Georgia Tech
ChengyuanLi,7,7,0,3,0,04/11/2012,KIAA-Clusters
cvillalon,7,7,0,0,0,04/20/2012,IATE
mmcd13,7,7,0,0,0,05/16/2012,MIT
marina,7,7,0,0,0,05/30/2012,Zürich
baldauf,7,7,0,0,0,05/30/2012,Zürich
gregreen,7,7,0,0,0,08/04/2012,Harvard ITC
shruti,7,7,0,0,0,08/17/2012,IUCAA
kfollette,7,7,0,0,0,08/22/2012,Arizona
mdrout,7,7,0,0,0,09/05/2012,Harvard ITC
rmontez,7,7,0,0,0,09/12/2012,Vanderbilt
cburns,7,7,0,0,0,09/26/2012,Carnegie
SandyRogers,7,7,0,0,0,10/11/2012,Edinburgh
sstorm,7,7,0,0,0,10/16/2012,University of Maryland
tilvi,7,7,0,0,0,10/17/2012,Texas A&M
Kory,7,7,0,0,0,10/18/2012,University of Maryland
nir_mandelker,7,7,0,0,0,10/31/2012,Hebrew University
jimgeach,7,7,0,0,0,11/16/2012,McGill
jcpassy,7,7,0,0,0,11/27/2012,AIfA
pofeng,7,7,0,0,0,12/10/2012,"IfA, University of Hawaii"
gvanbelle,7,7,0,0,0,12/11/2012,Lowell Observatory
stellar,7,7,0,0,0,01/23/2013,UniGoettingen
rajaguru,7,7,0,0,0,01/29/2013,IIA
andress5990,7,7,0,0,0,02/01/2013,Universidad de Costa Rica
sivarani,7,7,0,0,0,02/13/2013,IIA
JensRodmann,7,7,0,0,0,02/15/2013,UniGoettingen
stangalinimarco,7,7,0,0,0,03/01/2013,INAF-OAR
bloer,7,7,0,0,1,03/04/2013,Fermilab
asfont,7,7,0,0,0,03/12/2013,LJMU
alvaro,7,7,0,0,1,04/11/2013,Chicago-KICP
Mauricio Calvao,7,7,0,0,0,05/17/2013,UFRJ
joras,7,7,0,0,0,05/22/2013,UFRJ
Charles Margossian,7,7,0,0,0,06/10/2013,Yale-Planets
sampenny,7,7,0,0,0,08/01/2013,MoCA
Aina,7,7,0,3,0,08/22/2013,SIfA
bnorris,7,7,0,0,0,08/22/2013,SIfA
pelahi,7,7,0,0,0,08/23/2013,SIfA
StefanKeller,7,7,0,0,0,08/23/2013,RSAA-ANU
sandu,7,7,0,0,0,09/04/2013,UNLV
benjyman,7,7,0,0,0,09/17/2013,RSAA-ANU
ychen,7,7,0,0,0,09/17/2013,UW Madison
Jesse Feddersen,7,7,0,0,0,09/20/2013,Yale
alopez,7,7,0,0,0,10/02/2013,AAO
bmmorris,7,7,0,0,0,10/04/2013,University of Washington
sczoo,7,7,0,0,0,10/14/2013,Carnegie
Hung-Yi Pu,7,7,0,0,0,10/17/2013,ASIAA
hhsieh,7,7,0,0,0,10/18/2013,ASIAA
astrowright,7,7,0,0,0,10/30/2013,Penn State
poliva,7,7,0,0,0,11/07/2013,AAO
zrake,7,7,0,0,0,11/15/2013,Stanford
dhuppenkothen,7,7,0,0,0,11/19/2013,University of Amsterdam
zjiang,7,7,0,0,0,12/05/2013,NAOC
mbartelm,7,7,0,0,0,12/23/2013,University of Heidelberg ITP/ITA
benzgreen,7,7,0,0,0,01/21/2014,Yale-LSS
mcpowell,7,7,0,0,0,01/21/2014,Yale-LSS
irsic,7,7,0,0,0,01/24/2014,OATS
Tim D,7,7,0,0,0,01/29/2014,Cornell
pscholz,7,7,0,0,0,02/26/2014,McGill
vbouillot,7,7,0,0,0,08/05/2014,UCT Cosmology
awalters,7,7,0,0,0,08/05/2014,UCT Cosmology
Muzi,7,7,0,0,0,08/05/2014,UCT Cosmology
SHotchkiss,7,7,0,0,0,09/04/2014,"U. of Sussex, Astronomy Centre"
dwylezal,7,7,0,0,0,10/03/2014,Johns Hopkins
Lucas Secco,7,7,0,0,0,10/08/2014,CEFCA
karenyng,7,7,0,0,0,10/09/2014,UCD
alexs,7,7,0,0,0,10/09/2014,ICS
nicolas.cuello,7,7,0,0,0,10/09/2014,CRAL
jlj,7,7,0,0,0,10/23/2014,LANL
laureciesla,7,7,0,0,0,11/07/2014,University of Crete
MNeveu,7,7,0,0,0,11/20/2014,Exoplanets@Cambridge
Valentino,6,6,0,0,6,11/16/2009,UCR
Katie Morzinski,6,6,0,0,1,11/25/2009,Arizona
dfazi,6,6,0,0,1,07/21/2010,CIERA
arons,6,6,0,1,0,08/26/2010,UCB
deugarte,6,6,0,0,0,09/05/2010,DARK
milleric,6,6,0,0,0,11/08/2010,MIT
shirleyho,6,6,0,0,0,01/19/2011,UCB
Hakim Atek,6,6,0,0,0,02/03/2011,Caltech
branson,6,6,0,0,0,02/28/2011,UW Milwaukee
olrodrig,6,6,0,0,0,04/19/2011,UNAB
ameert,6,6,0,0,0,05/26/2011,UPenn
ialacern,6,6,0,0,0,06/03/2011,PUC-Institute of Astrophysics
Silvia Garbari,6,6,0,0,0,06/23/2011,Zürich
YiKuanChiang,6,6,0,0,0,08/29/2011,UT Austin
Jaime,6,6,0,0,0,09/05/2011,Uppsala
rychardbouwens,6,6,0,0,0,09/07/2011,Leiden
Bengt Edvardsson,6,6,0,1,0,09/07/2011,Uppsala
rutgersastro,6,6,0,0,0,09/07/2011,Rutgers
Jin-Cheng,6,6,0,0,0,09/14/2011,unaffiliated
leslielooney,6,6,0,0,0,09/15/2011,UIUC
rmallery,6,6,0,0,0,09/26/2011,UCR
erinMC,6,6,0,0,0,11/14/2011,UT Austin
ishivvers,6,6,0,0,0,11/17/2011,UCB
Alex,6,6,0,0,0,01/11/2012,AIfA-Cosmo
tim,6,6,0,0,0,01/12/2012,AIfA-Cosmo
atsushi.nishizawa,6,6,0,0,0,03/30/2012,Kavli IPMU
Lin,6,6,0,0,0,04/03/2012,Sabanci University
Veeresh Singh,6,6,0,0,0,04/06/2012,IAS Orsay
nakajima,6,6,0,0,0,04/12/2012,Kavli IPMU
Xiongwei Liu,6,6,0,1,0,04/23/2012,PKU
markus,6,6,0,0,0,05/25/2012,Zürich
andreufont,6,6,0,0,0,05/30/2012,Zürich
rlunnan,6,6,0,0,0,08/07/2012,Harvard ITC
bsar_rit,6,6,0,0,0,09/05/2012,RIT
luyu,6,6,0,0,0,09/07/2012,Stanford
Guo Zhen,6,6,0,1,0,09/14/2012,PKU
dsspiegel,6,6,0,0,0,09/18/2012,IAS
pslii,6,6,0,0,1,09/19/2012,Cornell
blackman,6,6,0,0,0,09/21/2012,University of Rochester
taylora,6,6,0,0,0,10/01/2012,DIAS
fcullen,6,6,0,1,0,10/11/2012,Edinburgh
maxmb.astro,6,6,0,0,0,10/16/2012,UofT
yevkissin,6,6,0,0,0,10/16/2012,UofT
clacey,6,6,0,0,0,10/17/2012,Durham University
yetrog,6,6,0,0,0,10/17/2012,Durham University
dufourf,6,6,0,0,0,10/18/2012,McGill
Karrie,6,6,0,0,0,10/19/2012,University of Washington
glansbury,6,6,0,0,0,10/22/2012,Durham University
dsalter,6,6,0,0,0,10/26/2012,University of Maryland
Alexander Fry,6,6,0,0,0,10/26/2012,University of Washington
joannawoo,6,6,0,0,0,10/31/2012,ETH-Extragalactic
klarson,6,6,0,0,0,11/06/2012,"IfA, University of Hawaii"
clhung,6,6,0,0,0,11/09/2012,"IfA, University of Hawaii"
delahaye,6,6,0,0,0,11/15/2012,McGill
cbrinkerink,6,6,0,0,0,11/19/2012,Radboud University Nijmegen
jmeyers314,6,6,0,0,0,01/15/2013,Stanford
marconi,6,6,0,0,0,01/16/2013,Osservatorio Astrofisico di Arcetri - Extragalactic
Dennisse C. Bolívar,6,6,0,0,0,01/21/2013,Universidad de Costa Rica
Axel,6,6,0,0,0,01/22/2013,AIfA-Cosmo
pgcasella,6,6,0,0,0,01/25/2013,INAF-OAR
pittori,6,6,0,1,0,01/28/2013,INAF-OAR
malves,6,6,0,0,0,01/31/2013,IAS Orsay - ISM
paulmirel,6,6,0,0,0,02/07/2013,NASA Goddard Space Flight Center
ajacobs,6,6,0,0,0,02/19/2013,Stony Brook
ranjanvv,6,6,0,0,0,02/22/2013,University of Maryland
brocato,6,6,0,0,0,02/27/2013,INAF-OAR
sibirrer,6,6,0,0,0,03/05/2013,ETH-Extragalactic
pmricker,6,6,0,0,0,03/08/2013,UIUC
ejennings,6,6,0,0,0,04/26/2013,Fermilab
snlongmore,6,6,0,0,0,04/30/2013,LJMU
alexis.arnaudon,6,6,0,0,0,06/03/2013,EPFL - UniGe
eganhila,6,6,0,0,0,06/06/2013,CU Boulder
astephens,6,6,0,0,0,07/09/2013,Gemini-North
sheap,6,6,0,0,0,07/26/2013,MoCA
Louis Abramson,6,6,0,0,0,07/27/2013,Chicago-KICP
celeste,6,6,0,0,0,09/03/2013,UIUC
jvanland,6,6,0,0,0,09/06/2013,University of Maryland
arepp,6,6,0,0,0,09/09/2013,"IfA, University of Hawaii"
nysa,6,6,0,0,0,09/18/2013,"U. of Sussex, Astronomy Centre"
bdrummond,6,6,0,0,0,10/07/2013,University of Exeter
holger.israel,6,6,0,0,0,10/08/2013,Durham University
JiaPeng,6,6,0,0,0,10/10/2013,Nanjing University
Onoddil,6,6,0,0,0,10/14/2013,University of Exeter
tkupfer,6,6,0,0,0,10/15/2013,Radboud University Nijmegen
russelltheporpoiseofscience,6,6,0,0,0,10/17/2013,University of Washington
mcmarch,6,6,0,0,0,10/18/2013,UPenn
manuell,6,6,0,0,0,10/22/2013,IAC
cmason,6,6,0,0,0,10/24/2013,UCSB
robert.crittenden@port.ac.uk,6,6,0,0,0,10/30/2013,ICG Portsmouth
kuntzer,6,6,0,0,0,11/04/2013,EPFL - UniGe
DitteS,6,6,0,0,0,11/12/2013,SAC
susanstewart_aa,6,6,0,2,0,11/14/2013,US Naval Observatory
bbenson_fnal,6,6,0,0,0,11/18/2013,Fermilab
gongyan2444,6,6,0,5,0,11/19/2013,PMO
Sarah Pearson,6,6,0,0,0,11/22/2013,Columbia
nbourne,6,6,0,0,0,11/27/2013,Edinburgh
Vivien Bonvin,6,6,0,0,0,12/05/2013,EPFL - UniGe
bmac,6,6,0,0,0,01/13/2014,Stanford
dom,6,6,0,0,0,01/16/2014,UIUC-SF
lif,6,6,0,0,0,01/20/2014,CEA Saclay
Claudia Antolini,6,6,0,0,0,01/27/2014,SISSA
fbianchini,6,6,0,0,0,01/29/2014,SISSA
Joyce Byun,6,6,0,0,0,01/30/2014,Cornell-Cosmo
shibi_kannan,6,6,0,0,0,02/17/2014,Yale-LSS
martin.kilbinger,6,6,0,0,0,02/21/2014,CEA Saclay CosmoStat
jevans,6,6,0,0,0,03/04/2014,UIUC-SF
mtpenny,6,6,0,0,0,03/19/2014,OSU Astronomy
jtayar,6,6,0,0,0,03/19/2014,OSU Astronomy
haruka_kusakabe,6,6,0,0,0,04/10/2014,University of Tokyo
ruolanjin,6,6,0,0,0,04/10/2014,NTHU
erica,6,6,0,0,0,05/18/2014,FSU Astrophysics
smb377,6,6,0,0,0,05/21/2014,Cornell-Cosmo
Sean Fillingham,6,6,0,0,0,05/22/2014,UCI
vlakey,6,6,0,0,0,06/06/2014,FSU Astrophysics
Grant Tremblay,6,6,0,0,0,09/03/2014,Yale
dcasanova,6,6,0,0,0,09/08/2014,UW Madison
boazka,6,6,0,0,0,09/11/2014,Weizmann Institute of Science
grant,6,6,0,0,0,09/19/2014,Exoplanets@Cambridge
ejwsps,6,6,0,0,0,09/25/2014,RIT-CCRG
solerjuan,6,6,0,0,0,10/07/2014,IAS Orsay - ISM
guillaume.mahler,6,6,0,0,0,10/07/2014,CRAL
gferrero,6,6,0,0,0,10/16/2014,IALP-FCAGLP
dpelliccia,6,6,0,0,0,10/21/2014,LAM
cmalone,6,6,0,0,2,10/21/2014,LANL
Cullan Howlett,6,6,0,0,0,10/31/2014,ICG Portsmouth
sandipan,6,6,0,0,0,11/04/2014,Cornell LEPP-STRINGS
ANC,6,6,0,0,0,11/06/2014,Exoplanets@Cambridge
justyn,5,4,1,0,0,06/29/2010,DARK
phumphrey,5,4,1,0,0,04/09/2013,UCI
Sarah,5,5,0,6,6,08/27/2009,UCSC
Laurel,5,5,0,0,5,09/24/2009,UCSC
crodriguez,5,5,0,0,0,07/06/2010,CIERA
vivien,5,5,0,0,0,07/12/2010,CIERA
jhshiode,5,5,0,0,0,09/14/2010,UCB
davemeyer,5,5,0,0,0,09/22/2010,CIERA
jtrump,5,5,0,0,4,09/23/2010,Penn State
Pierre Guillard,5,5,0,0,0,11/29/2010,IAS Orsay
ekempton,5,5,0,0,0,12/03/2010,UCSC
peletier,5,5,0,0,0,01/06/2011,Kapteyn
matteo,5,5,0,0,0,02/02/2011,Leiden
Hassen,5,5,0,1,2,02/05/2011,UCSC
annas,5,5,0,0,0,02/18/2011,Swinburne
Kyle Penner,5,5,0,0,0,04/19/2011,Arizona
Ju.,5,5,0,0,0,04/27/2011,IAS Orsay
danielgruen,5,5,0,0,0,05/23/2011,UPenn
douglase,5,5,0,0,0,06/09/2011,Boston University
upasana_das,5,5,0,0,0,07/06/2011,IISc-RRI
myjeon,5,5,0,0,0,07/25/2011,UT Austin
gcostigan,5,5,0,0,0,08/19/2011,DIAS
zzy,5,5,0,0,0,08/19/2011,ASU Astro
gmurphy,5,5,0,0,0,08/20/2011,unaffiliated
atlee,5,5,0,0,0,08/29/2011,Arizona
aclocchiatti,5,5,0,0,0,09/08/2011,PUC-Institute of Astrophysics
Chuanwu Liu,5,5,0,1,0,09/10/2011,unaffiliated
gam@iap.fr,5,5,0,0,0,09/26/2011,IAP Cosmology and Extragalactic
brad.warren,5,5,0,0,0,10/14/2011,unaffiliated
MM,5,5,0,0,0,10/17/2011,ICRAR
Sabyasachi,5,5,0,0,0,10/20/2011,ICRAR
plopes,5,5,0,0,0,10/27/2011,Valongo Observatory
durant,5,5,0,1,0,10/31/2011,University of Florida
vulpecula,5,5,0,0,0,11/04/2011,University of Vienna
eigenthaler,5,5,0,0,0,11/08/2011,University of Vienna
Emilio,5,5,0,0,0,11/14/2011,AIfA-Cosmo
Sayan Chakraborti,5,5,0,0,0,11/27/2011,Harvard ITC
kkraljic,5,5,0,0,0,11/28/2011,LAM
lfortson,5,5,0,0,0,12/06/2011,UMN
bharadwaj,5,5,0,0,0,12/12/2011,AIfA-Cosmo
gurtina,5,5,0,0,0,12/15/2011,Arizona
cpankow,5,5,0,0,0,01/04/2012,UW Milwaukee
MathieuR,5,5,0,0,0,01/10/2012,IAS Orsay
Panos,5,5,0,0,0,01/23/2012,EPFL - UniGe
Brooke Simmons,5,5,0,1,0,01/27/2012,Oxford University - Galaxies
atolley438,5,5,0,0,0,02/03/2012,unaffiliated
riotto,5,5,0,0,0,02/16/2012,Geneva Cosmology Group
mccavana,5,5,0,0,0,02/20/2012,AOB
edibon,5,5,0,0,0,03/20/2012,AOB
uhm,5,5,0,0,0,04/13/2012,UNLV
saju,5,5,0,0,0,04/20/2012,UNLV
comhy25,5,5,0,0,0,04/24/2012,PKU
mvanadel,5,5,0,0,0,04/27/2012,Georgia Tech
tpeters,5,5,0,0,0,05/31/2012,Zürich
jdiemand,5,5,0,0,0,07/05/2012,Zürich
QianYang,5,5,0,0,0,07/20/2012,PKU
Kajron,5,5,0,0,0,07/25/2012,University of Vienna
iczekala,5,5,0,0,0,08/06/2012,Harvard ITC
swellons,5,5,0,0,0,08/07/2012,Harvard ITC
marcar,5,5,0,0,0,08/09/2012,Caltech
asmith,5,5,0,0,0,08/27/2012,UT Austin
wagoner,5,5,0,0,0,08/29/2012,Stanford
bcanning,5,5,0,0,0,09/04/2012,Stanford
mpaegert,5,5,0,0,0,09/04/2012,Vanderbilt
bdfields,5,5,0,0,0,09/20/2012,UIUC
behroozi,5,5,0,0,0,09/25/2012,Stanford
mansi,5,5,0,0,0,09/27/2012,Carnegie
robderosa,5,5,0,0,0,09/28/2012,University of Exeter
arrudy,5,5,0,0,1,10/03/2012,UCSC
jlzhang,5,5,0,0,0,10/16/2012,UofT
Steven Janssens,5,5,0,0,0,10/16/2012,UofT
rdg,5,5,0,0,0,10/17/2012,Edinburgh
mrizzo,5,5,0,0,0,10/18/2012,University of Maryland
RichardStancliffe,5,5,0,0,0,10/19/2012,AIfA
eclake,5,5,0,0,0,10/24/2012,Edinburgh
psaha,5,5,0,0,0,11/01/2012,Zürich
glbetanc,5,5,0,0,0,11/06/2012,NASA Goddard Space Flight Center
davidcseh,5,5,0,0,0,11/19/2012,Radboud University Nijmegen
Jon Richardson,5,5,0,0,0,12/05/2012,Chicago-KICP
Konstantinos,5,5,0,0,0,12/13/2012,University of Birmingham
Chris Collins,5,5,0,0,1,12/18/2012,University of Birmingham
adshead,5,5,0,0,0,01/10/2013,UIUC
britton,5,5,0,0,0,01/15/2013,Edinburgh
ngbusca,5,5,0,0,0,01/29/2013,APC
jkaplan,5,5,0,0,0,01/30/2013,APC
hsmith,5,5,0,0,0,02/05/2013,Michigan State
hessman,5,5,0,0,0,02/22/2013,UniGoettingen
mgentile,5,5,0,0,0,02/26/2013,EPFL - UniGe
bauer,5,5,0,0,0,02/28/2013,Fermilab
sheinis,5,5,0,0,0,04/05/2013,University of Maryland
CCavig,5,5,0,0,0,05/21/2013,STScI/JHU
jd,5,5,0,0,0,06/12/2013,University of Washington
acc,5,5,0,1,0,06/16/2013,University of Hertfordshire
brodgers,5,5,0,0,0,07/03/2013,Gemini-South
johnl,5,5,0,0,0,07/25/2013,MoCA
pimbblet,5,5,0,0,0,07/26/2013,MoCA
egrand,5,5,0,0,0,09/04/2013,University of Maryland
abiliomateus,5,5,0,0,0,09/05/2013,UFSC (GAS)
leonbaruah,5,5,0,0,0,09/19/2013,"U. of Sussex, Astronomy Centre"
dstn,5,5,0,0,0,09/23/2013,University of Waterloo
Yixian Cao,5,5,0,0,0,09/24/2013,UIUC
rhdtownsend,5,5,0,0,0,09/30/2013,UW Madison
ntampaka,5,5,0,0,0,09/30/2013,Carnegie Mellon University
sdr,5,5,0,0,0,10/01/2013,AAO
benny.trakht,5,5,0,0,0,10/02/2013,ETH-Extragalactic
kxguo,5,5,0,0,0,10/03/2013,"U. of Sussex, Astronomy Centre"
imv,5,5,0,0,0,10/03/2013,IAC
Stewart,5,5,0,0,0,10/03/2013,University of Southampton
elf,5,5,0,0,0,10/04/2013,CEA Saclay
lhowes,5,5,0,0,0,10/08/2013,RSAA-ANU
njm202,5,5,0,0,0,10/10/2013,University of Exeter
HRWakeford,5,5,0,0,0,10/14/2013,University of Exeter
ajm,5,5,0,0,0,10/17/2013,ASIAA
eklimek,5,5,0,0,0,11/08/2013,NMSU
mtailo,5,5,0,0,0,11/21/2013,INAF-OAR
samao,5,5,0,0,0,11/24/2013,UW Madison
wkarman,5,5,0,0,0,11/26/2013,Kapteyn-HI
Regner,5,5,0,0,0,11/29/2013,SAC
MarkusR,5,5,0,0,0,12/05/2013,EPFL - UniGe
jvanroestel,5,5,0,0,0,12/13/2013,Radboud University Nijmegen
Shigeki,5,5,0,0,0,12/28/2013,Hebrew University
hayato,5,5,0,0,0,01/14/2014,Chicago-KICP
Bomeelee,5,5,0,0,0,01/15/2014,UMass Amherst
James Toomey,5,5,0,0,0,01/16/2014,University of Iowa
sarrvesh.ss,5,5,0,0,0,01/27/2014,Kapteyn-HI
lhunt,5,5,0,0,0,02/02/2014,WVU
bjk98,5,5,0,0,0,02/06/2014,Cornell-Cosmo
hsutailee,5,5,0,0,0,02/07/2014,UIUC-SF
Matthew,5,5,0,0,0,02/19/2014,ICG Portsmouth
AnnaFeltre,5,5,0,0,0,03/12/2014,IAP Cosmology and Extragalactic
amelie,5,5,0,0,0,03/18/2014,UCL Extragalactic Journal Club
hughlip,5,5,0,0,0,03/21/2014,Fermilab
Daniel Guariento,5,5,0,0,0,03/21/2014,Perimeter Institute for Theoretical Physics
Athira,5,5,0,0,0,03/25/2014,MoCA
tqw,5,5,0,0,0,04/02/2014,Nanjing University
chiaratonini,5,5,0,0,0,04/04/2014,University of Melbourne
EnaChoi,5,5,0,0,0,05/27/2014,Rutgers
diyaddin,5,5,0,0,0,06/12/2014,Istanbul University
ghallenbeck,5,5,0,0,0,06/24/2014,Cornell
Lariff,5,5,0,0,0,08/15/2014,PMO
Chris Hayward,5,5,0,0,0,09/03/2014,Caltech
glenna,5,5,0,0,0,09/09/2014,Vanderbilt
Florent Leclercq,5,5,0,0,0,09/16/2014,IAP Cosmology and Extragalactic
yacine,5,5,0,0,0,09/17/2014,Johns Hopkins
dmolnar,5,5,0,0,0,09/26/2014,"U. of Sussex, Astronomy Centre"
athoag,5,5,0,0,0,10/03/2014,UCD
gavagnin,5,5,0,0,0,10/14/2014,ICS
jdolence,5,5,0,0,0,10/23/2014,LANL
mwithers,5,5,0,0,0,10/24/2014,ICG Portsmouth
tomhartman,5,5,0,0,0,11/04/2014,Cornell LEPP-STRINGS
Liam,5,5,0,0,0,11/06/2014,Cornell LEPP-STRINGS
Lady Alex,5,5,0,2,0,11/14/2014,UCSB HEP/Gravity
blinov,5,5,0,0,0,11/14/2014,University of Crete
tiitsepp,5,5,0,0,0,12/08/2014,Tartu Obs
davidw,4,3,1,0,0,11/21/2013,Hebrew University
Serena,4,4,0,0,0,07/27/2009,UCSC
David Rosario,4,4,0,0,2,08/13/2009,UCSC
Jill Naiman,4,4,0,0,1,11/19/2009,UCSC
Eric,4,4,0,0,6,11/23/2009,UCSC
David Lai,4,4,0,0,0,02/17/2010,UCSC
Val,4,4,0,1,4,06/08/2010,UCSC
berian,4,4,0,0,0,07/01/2010,DARK
JHwang,4,4,0,0,0,08/11/2010,CIERA
antheaking,4,4,0,0,0,08/12/2010,DARK
jmcbride,4,4,0,0,0,08/24/2010,unaffiliated
saw,4,4,0,0,0,08/25/2010,UofT
Allyson,4,4,0,0,0,09/14/2010,Columbia
ehamden,4,4,0,0,0,09/20/2010,Columbia
dabrusco,4,4,0,0,0,10/22/2010,HEAD-CfA
Dale Graessle,4,4,0,0,0,11/05/2010,Harvard ITC
Jeroen,4,4,0,0,0,11/22/2010,Leiden
fsalmi,4,4,0,0,0,12/06/2010,CEA Saclay
trejo,4,4,0,0,0,02/08/2011,ASIAA
Chanda,4,4,0,0,0,02/23/2011,MIT
evelyn,4,4,0,0,0,02/25/2011,Swinburne
jaguirre,4,4,0,0,0,05/26/2011,UPenn
mitchs,4,4,0,0,0,05/26/2011,UPenn
mlalonso,4,4,0,0,0,06/09/2011,PUC-Institute of Astrophysics
andres.jordan,4,4,0,0,0,06/10/2011,PUC-Institute of Astrophysics
trlinden,4,4,0,0,0,07/10/2011,Chicago-KICP
bidya,4,4,0,0,0,07/14/2011,IISc-RRI
arefreg,4,4,0,0,0,07/20/2011,ETH-Extragalactic
bev,4,4,0,0,0,07/25/2011,UT Austin
fxt,4,4,0,0,0,08/18/2011,ASU Astro
David Schlachtberger,4,4,0,0,0,09/09/2011,unaffiliated
Yeisson Osorio,4,4,0,0,0,09/09/2011,Uppsala
Zheng Xiaochen,4,4,0,0,0,09/13/2011,KIAA-Clusters
amarante,4,4,0,0,0,10/13/2011,Valongo Observatory
jacintadelhaize,4,4,0,0,0,10/14/2011,ICRAR
lee.s.kelvin,4,4,0,0,0,10/14/2011,ICRAR
bjweiner,4,4,0,0,0,10/20/2011,Arizona
Miriam Krauss,4,4,0,0,0,11/02/2011,Caltech
grepe,4,4,0,0,0,11/18/2011,AIfA-Cosmo
semboloni,4,4,0,0,0,11/23/2011,Leiden-NOLG
noelia,4,4,0,1,0,12/01/2011,ETH-Extragalactic
janosb,4,4,0,0,0,01/09/2012,UCB
Julia,4,4,0,0,0,01/25/2012,University of Vienna
dmpahud,4,4,0,0,0,01/26/2012,Boston University
kayleanelson,4,4,0,0,0,01/27/2012,Yale
Richard,4,4,0,0,0,02/03/2012,ICRAR
lisaphy,4,4,0,0,0,02/17/2012,Rutgers
deirdre,4,4,0,1,1,03/02/2012,Georgia Tech
weihua,4,4,0,0,0,03/09/2012,HUST astro
prasun,4,4,0,0,0,04/19/2012,NCRA
Laura Donoso,4,4,0,0,0,06/04/2012,IATE
jlallen,4,4,0,0,0,06/11/2012,MIT
saurav,4,4,0,0,0,07/06/2012,Boston University
Andrew Crooks,4,4,0,0,0,07/22/2012,UCR
Prajval Shastri,4,4,0,0,0,08/07/2012,IIA
andycasey,4,4,0,0,0,08/15/2012,MIT
Justin Vandenbroucke,4,4,0,0,0,08/20/2012,WIPAC
djbard,4,4,0,0,0,08/21/2012,Stanford
anupreeta,4,4,0,0,0,09/07/2012,Kavli IPMU
Shangguan Jinyi,4,4,0,0,0,09/14/2012,PKU
jgrube,4,4,0,0,0,09/18/2012,Adler Planetarium
hwwspoon,4,4,0,0,0,10/08/2012,Cornell
MarcP,4,4,0,0,0,10/15/2012,University of Maryland
mwolfire,4,4,0,0,0,10/15/2012,University of Maryland
connor,4,4,0,0,0,10/16/2012,UofT
liutiepku,4,4,0,0,0,10/23/2012,PKU
jose,4,4,0,0,0,10/25/2012,Edinburgh
guillermo,4,4,0,0,0,10/26/2012,Geneva Cosmology Group
mclark3,4,4,0,0,0,10/31/2012,Georgia Tech
dbfisher,4,4,0,0,0,11/02/2012,University of Maryland
tressell,4,4,0,0,0,11/16/2012,Chicago-KICP
roderik65,4,4,0,0,0,11/21/2012,Gemini-South
ewenderoth,4,4,0,0,0,11/22/2012,Gemini-South
antonellagarzilli,4,4,0,0,0,12/03/2012,Durham University
Richard I. Anderson,4,4,0,0,0,12/04/2012,Johns Hopkins
Chat Hull,4,4,0,0,0,12/05/2012,Harvard ITC
Chiara Mingarelli,4,4,0,0,0,12/12/2012,Caltech
nlee,4,4,0,0,0,12/13/2012,"IfA, University of Hawaii"
julie.skinner,4,4,0,0,7,01/17/2013,Boston University
Ricardo,4,4,0,0,0,01/20/2013,Universidad de Costa Rica
pkharb,4,4,0,0,0,01/26/2013,IIA
JulienP,4,4,0,0,0,01/29/2013,APC
Alexander Heger,4,4,0,0,0,01/30/2013,MoCA
AnnaParikka,4,4,0,0,0,01/31/2013,IAS Orsay - ISM
denis,4,4,0,0,0,01/31/2013,UniGoettingen
fnicastro,4,4,0,0,0,02/07/2013,INAF-OAR
dcarson,4,4,0,0,0,02/14/2013,UCI
JulienL,4,4,0,0,0,02/18/2013,APC
cjhogan,4,4,0,0,0,03/03/2013,Fermilab
scarsaez,4,4,0,0,0,03/21/2013,"U. de Concepcion: Planetary, Stellar, Galactic, Extragalactic papers"
jschewts,4,4,0,0,0,04/24/2013,Durham University
wester,4,4,0,0,0,05/20/2013,Fermilab
rob,4,4,0,0,0,05/31/2013,INAF-OAR
virajpandya,4,4,0,0,0,06/03/2013,Rutgers
federico.marocco,4,4,0,0,0,06/28/2013,University of Hertfordshire
esquivas,4,4,0,0,0,07/24/2013,ICN-UNAM
jayb,4,4,0,0,0,08/05/2013,"U. de Concepcion: Planetary, Stellar, Galactic, Extragalactic papers"
alex clarke,4,4,0,0,0,08/08/2013,University of Southampton
rnealon,4,4,0,0,0,08/20/2013,MoCA
luke.shingles,4,4,0,0,0,08/22/2013,RSAA-ANU
gbrammer,4,4,0,0,0,08/22/2013,STScI/JHU
mosby,4,4,0,1,0,09/16/2013,UW Madison
frenchd,4,4,0,0,0,09/16/2013,UW Madison
rolandcrocker,4,4,0,0,0,09/17/2013,RSAA-ANU
dmunoz,4,4,0,0,0,09/19/2013,Cornell
lundgren,4,4,0,1,0,09/25/2013,UW Madison
griffin,4,4,0,0,0,10/01/2013,UCSB
jana,4,4,0,0,0,10/08/2013,IAC
qianlivan,4,4,0,0,0,10/10/2013,NAOC
jjohnson@cfa.harvard.edu,4,4,0,0,0,10/16/2013,Harvard ITC
casiana,4,4,0,0,0,10/21/2013,IAC
aravindnatarajan,4,4,0,0,0,10/21/2013,U. Pittsburgh
plm1g08,4,4,0,0,0,10/29/2013,University of Southampton
naoko,4,4,0,0,0,11/04/2013,Fermilab
fgj,4,4,0,0,0,11/12/2013,SAC
mario,4,4,0,0,0,11/13/2013,LAM
clidman,4,4,0,0,0,11/13/2013,AAO
pen,4,4,0,0,0,11/13/2013,SAC
rstoll,4,4,0,0,0,11/15/2013,Yale-Planets
Bryant,4,4,0,0,0,11/19/2013,Stanford
hubo1988,4,4,0,3,0,11/19/2013,PMO
YuanWang,4,4,0,2,0,11/19/2013,PMO
ben margalit,4,4,0,0,0,11/21/2013,Hebrew University
sepps,4,4,0,0,0,11/27/2013,University of Waterloo
benjamin_czaja,4,4,0,0,0,12/10/2013,University of Utah
yiping,4,4,0,0,0,12/14/2013,University of Utah
rruizc,4,4,0,0,0,12/17/2013,Radboud University Nijmegen
koaoact,4,4,0,0,0,01/06/2014,"IfA, University of Hawaii"
manupomax,4,4,0,0,0,01/09/2014,OATS
matteoviel,4,4,0,0,0,01/14/2014,INAF-OAR
mcm,4,4,0,0,0,01/22/2014,OATS
jlusk,4,4,0,0,0,01/22/2014,University of Oklahoma
rkeeley,4,4,0,0,0,01/23/2014,UCI
Antonino Marasco,4,4,0,0,0,01/27/2014,Kapteyn-HI
Shravan.Shetty,4,4,0,0,0,01/31/2014,Oxford University - Galaxies
KatieR,4,4,0,0,0,02/02/2014,WVU
nipuni,4,4,0,0,0,02/02/2014,WVU
akshaya,4,4,0,0,0,02/03/2014,WVU
kyim,4,4,0,0,0,02/03/2014,Kapteyn-HI
isanroman,4,4,0,0,0,02/05/2014,CEFCA
pcapak,4,4,0,0,0,02/13/2014,Caltech
hannah_marlowe,4,4,0,0,0,02/18/2014,University of Iowa
sirwin,4,4,0,0,0,02/19/2014,Florida Tech
giadaarney,4,4,0,0,0,03/07/2014,University of Washington
mgj37,4,4,0,0,0,03/08/2014,Cornell
kinsuk84,4,4,0,0,0,03/16/2014,NTHU
ABermeo,4,4,0,0,0,03/27/2014,"U. of Sussex, Astronomy Centre"
Paula Sanchez,4,4,0,0,0,04/03/2014,UChile - Calan
ddevost,4,4,0,0,0,04/15/2014,CFHT
fernandozhs,4,4,0,0,0,05/13/2014,U. Pittsburgh
windemut,4,4,0,0,0,05/16/2014,University of Washington
astroyuan,4,4,0,0,0,06/06/2014,NTHU
mbelyaev,4,4,0,0,0,06/27/2014,UCB
Kazu Akiyama,4,4,0,0,0,06/30/2014,University of Tokyo
phphipps,4,4,0,0,0,08/05/2014,Boston University
yfeng1,4,4,0,0,0,08/22/2014,UCB cosmology
Alex Kim,4,4,0,0,0,08/22/2014,UCB cosmology
dasmus,4,4,0,0,0,09/01/2014,UChile - Calan
leonardoaa,4,4,0,0,0,09/09/2014,Johns Hopkins
Tim Johannsen,4,4,0,0,0,09/09/2014,University of Waterloo
steven_silverberg,4,4,0,0,0,09/10/2014,University of Oklahoma
mkmcc,4,4,0,0,0,09/15/2014,Harvard ITC
Scott T,4,4,0,0,0,09/20/2014,Exoplanets@Cambridge
akraus,4,4,0,0,0,09/25/2014,UT Austin
ozgecan,4,4,0,0,0,10/01/2014,Istanbul University
Elisabetta,4,4,0,0,0,10/06/2014,IAS Orsay - ISM
aremyruyer,4,4,0,0,0,10/07/2014,IAS Orsay - ISM
yetlirosas,4,4,0,0,0,10/16/2014,CRAL
mbutler,4,4,0,0,0,10/16/2014,ICS
ipolderman,4,4,0,0,0,10/21/2014,Radboud University Nijmegen
Chris Clarkson,4,4,0,0,0,10/29/2014,UCT Cosmology
elmo,4,4,0,0,0,11/11/2014,Tartu Obs
alexmar,4,4,0,1,0,11/12/2014,University of Crete
arianna,4,4,0,0,0,11/20/2014,DARK
Eric,4,4,0,1,0,11/25/2014,UCSB HEP/Gravity
roberto,4,4,0,0,0,12/01/2014,IALP-FCAGLP
mbersten,4,4,0,0,0,12/01/2014,IALP-FCAGLP
IgnacioGargiulo,4,4,0,0,0,12/03/2014,IALP-FCAGLP
gak,3,2,1,0,0,02/05/2014,STScI-AGN
Tesla,3,3,0,3,4,07/28/2009,UCSC
vduez,3,3,0,0,0,07/13/2010,AIfA
sanghamitra,3,3,0,0,0,07/14/2010,CIERA
mgeorge,3,3,0,0,0,08/23/2010,UCB
stmcwill,3,3,0,0,0,09/20/2010,Columbia
assafh,3,3,0,0,0,11/03/2010,Weizmann Institute of Science
frentzilla,3,3,0,0,0,11/18/2010,CIERA
elbaz,3,3,0,0,0,12/13/2010,CEA Saclay
kylin,3,3,0,0,0,01/31/2011,ASIAA
martinaf,3,3,0,0,0,02/01/2011,DARK
gms48,3,3,0,0,0,02/24/2011,U. Pittsburgh
timothyarnold,3,3,0,0,0,03/08/2011,Arizona
neumayer,3,3,0,0,0,03/21/2011,ESO Garching
edcastillo,3,3,0,0,0,04/01/2011,PUC-Institute of Astrophysics
anjaa.dark,3,3,0,0,0,04/05/2011,DARK
vguillet,3,3,0,0,0,04/12/2011,IAS Orsay - ISM
kalatalo,3,3,0,0,0,04/14/2011,Caltech
cosmoseb,3,3,0,0,0,04/14/2011,IAS Orsay
tana,3,3,0,0,0,04/27/2011,HEAD-CfA
gitorrea,3,3,0,0,0,05/16/2011,PUC-Institute of Astrophysics
tyrsojoy,3,3,0,0,0,05/26/2011,UPenn
nathans,3,3,0,0,0,06/03/2011,Arizona
shwetketu,3,3,0,0,0,06/16/2011,unaffiliated
mbaubock,3,3,0,0,0,06/28/2011,Arizona
bsesar,3,3,0,0,0,07/05/2011,Caltech
cyou,3,3,0,0,0,07/11/2011,Arizona
mikemon,3,3,0,0,0,07/25/2011,UT Austin
clindner,3,3,0,0,0,08/18/2011,UT Austin
wgray,3,3,0,0,0,08/29/2011,ASU Astro
Jenn Donley,3,3,0,0,0,09/07/2011,STScI/JHU
chenxiaodian,3,3,0,0,0,09/09/2011,KIAA-Clusters
lmd,3,3,0,0,0,09/15/2011,CRAL
BrianF,3,3,0,0,0,09/21/2011,STScI/JHU
dreboll3,3,3,0,0,0,09/21/2011,UIUC-SF
iwstephens,3,3,0,0,0,09/23/2011,UIUC-SF
fluke,3,3,0,0,0,09/29/2011,MPA Garching
alyoung,3,3,0,0,0,10/07/2011,UPenn
stdd304,3,3,0,0,0,11/07/2011,University of Vienna
dwjust,3,3,0,0,0,11/07/2011,UofT
Nina Roth,3,3,0,0,0,11/14/2011,AIfA-Cosmo
jpollack,3,3,0,0,0,11/16/2011,AIfA-Cosmo
KCook3824,3,3,0,0,0,11/18/2011,Texas A&M
sgiodini,3,3,0,0,0,11/23/2011,Leiden-NOLG
vivien.parmentier,3,3,0,0,0,12/19/2011,UCSC
claw,3,3,0,0,0,01/09/2012,UCB
caseywstark,3,3,0,0,0,01/19/2012,UCB
parejkoj,3,3,0,0,0,02/03/2012,Yale
esrabulbul,3,3,0,0,0,02/15/2012,Harvard ITC
Jose.Beltran,3,3,0,0,0,02/16/2012,Geneva Cosmology Group
aranha,3,3,0,1,0,03/02/2012,Georgia Tech
laurenhuang,3,3,0,0,0,03/07/2012,ASIAA
pkgw,3,3,0,0,0,03/20/2012,Harvard ITC
gaohe,3,3,0,0,0,03/22/2012,UNLV
kipmu,3,3,0,0,0,03/28/2012,Kavli IPMU
darkgrb,3,3,0,0,0,03/29/2012,UNLV
Yang JY,3,3,0,0,0,04/16/2012,DoA PKU
enezri,3,3,0,0,0,04/18/2012,LAM
pinwei,3,3,0,0,0,05/09/2012,LAM
James Casey,3,3,0,0,0,05/11/2012,Georgia Tech
ejos,3,3,0,0,0,05/22/2012,HEAD-CfA
mmora,3,3,0,0,0,06/01/2012,PUC-Institute of Astrophysics
mayuri,3,3,0,0,0,06/05/2012,IISc-RRI
abraham.neben,3,3,0,0,0,06/05/2012,MIT
framos,3,3,0,0,0,06/05/2012,IATE
lecoanet,3,3,0,0,0,07/13/2012,UCB
mackce,3,3,0,0,0,08/07/2012,Vanderbilt
Kaustubh,3,3,0,0,0,08/09/2012,IUCAA
shibasish,3,3,0,0,0,08/31/2012,IUCAA
Nicola Mehrtens,3,3,0,0,0,08/31/2012,Texas A&M
jlunine,3,3,0,1,0,09/04/2012,Cornell
pchristian,3,3,0,0,0,09/05/2012,Harvard ITC
Erika Grundstrom,3,3,0,0,0,09/10/2012,Vanderbilt
maoqingqing,3,3,0,0,0,09/10/2012,Vanderbilt
ktsoto,3,3,0,0,0,09/11/2012,ETH-Extragalactic
bethreid,3,3,0,0,0,09/17/2012,UCB
fnauman,3,3,0,0,0,09/19/2012,University of Rochester
gilholder,3,3,0,0,0,09/27/2012,McGill
yajie,3,3,0,0,0,10/02/2012,Stanford
kelson,3,3,0,6,0,10/02/2012,Carnegie
phopkins,3,3,0,0,0,10/04/2012,Caltech
msk,3,3,0,0,0,10/18/2012,University of Maryland
yusra,3,3,0,0,0,10/25/2012,University of Washington
mrickert,3,3,0,0,0,11/12/2012,CIERA
mlieu,3,3,0,0,0,11/23/2012,University of Birmingham
jjadams,3,3,0,0,0,11/26/2012,Carnegie
Alex Fitts,3,3,0,0,0,11/30/2012,University of Maryland
Chris Richardson,3,3,0,0,0,12/11/2012,Michigan State
mfurlong,3,3,0,0,0,01/15/2013,Durham University
nysard,3,3,0,0,0,01/31/2013,IAS Orsay - ISM
ehabart,3,3,0,0,0,01/31/2013,IAS Orsay - ISM
iruchlin,3,3,0,0,0,02/04/2013,RIT-CCRG
roucelle,3,3,0,0,0,02/05/2013,APC
tmhughes,3,3,0,0,0,02/08/2013,Ghent University
pablo,3,3,0,0,0,02/20/2013,AIfA
mattcwilde,3,3,0,0,0,02/22/2013,AMNH
gnedin,3,3,0,0,0,02/28/2013,Fermilab
achou,3,3,0,0,2,03/04/2013,Fermilab
jcalanog,3,3,0,0,0,03/07/2013,UCI
allafort,3,3,0,0,0,04/16/2013,Stanford
Jmak,3,3,0,0,0,05/01/2013,LJMU
clreichardt,3,3,0,0,0,05/15/2013,UCB
rvdb,3,3,0,0,0,05/27/2013,MPIA
viniciusvmb,3,3,0,0,0,05/28/2013,UFRJ
tpapalex,3,3,0,0,0,05/28/2013,Yale-Planets
Peterbeck,3,3,0,1,0,06/16/2013,University of Hertfordshire
bwvdnbro,3,3,0,0,0,06/17/2013,Ghent University
gmanser,3,3,0,0,0,06/18/2013,University of Hertfordshire
esthermq,3,3,0,0,0,06/18/2013,Edinburgh
BryanMiller,3,3,0,0,0,06/27/2013,Gemini-South
rmiranda,3,3,0,0,0,07/01/2013,Cornell
Cole Holcomb,3,3,0,0,0,07/18/2013,unaffiliated
diogobelloni,3,3,0,0,0,07/29/2013,UFRJ
outsider,3,3,0,0,0,08/01/2013,MoCA
Alexa,3,3,0,0,1,08/05/2013,UCSC
dbayliss,3,3,0,0,0,08/26/2013,RSAA-ANU
kelseyf,3,3,0,0,0,08/26/2013,Michigan State
corbin,3,3,0,0,0,08/29/2013,University of Maryland
scroom,3,3,0,0,0,09/02/2013,SIfA
fogarty,3,3,0,0,0,09/02/2013,SIfA
nhill,3,3,0,0,0,09/17/2013,UW Madison
stephenwilkins,3,3,0,0,0,09/18/2013,"U. of Sussex, Astronomy Centre"
csheehy,3,3,0,0,0,09/23/2013,Chicago-KICP
plaplant,3,3,0,0,0,09/23/2013,Carnegie Mellon University
jkrogager,3,3,0,0,0,09/26/2013,DARK
pascal xavier,3,3,0,0,0,10/01/2013,AAO
Joana,3,3,0,0,0,10/01/2013,Osservatorio Astrofisico di Arcetri - Extragalactic
KlausReinsch,3,3,0,0,0,10/01/2013,UniGoettingen
Gerhard Ulbricht,3,3,0,0,0,10/04/2013,UCSB
RCanameras,3,3,0,0,0,10/07/2013,IAS Orsay
Fang,3,3,0,0,0,10/08/2013,RSAA-ANU
yangstfyou,3,3,0,0,0,10/10/2013,Nanjing University
phoeberus,3,3,0,0,0,10/11/2013,University of Washington
carlos.zarro,3,3,0,0,0,10/11/2013,UFRJ
Ming Zhao,3,3,0,0,0,10/14/2013,Penn State
RWorth,3,3,0,0,0,10/14/2013,Penn State
ChrisDandrea,3,3,0,0,0,10/28/2013,ICG Portsmouth
jacobo,3,3,0,0,0,10/29/2013,UIUC
weast,3,3,0,0,0,11/01/2013,Stanford
Tomas Stolker,3,3,0,0,0,11/05/2013,University of Amsterdam
jorge barrera,3,3,0,0,0,11/11/2013,IAC
karoff,3,3,0,1,0,11/12/2013,SAC
Lundkvist,3,3,0,0,0,11/12/2013,SAC
Maryam,3,3,0,0,0,11/13/2013,ETH-Extragalactic
guldog,3,3,0,0,0,11/13/2013,SAC
lucyh,3,3,0,0,0,11/13/2013,University of Amsterdam
jcd,3,3,0,0,0,11/14/2013,SAC
gladstone,3,3,0,0,0,11/14/2013,WIPAC
jeanm12,3,3,0,0,0,11/14/2013,NMSU
nmule,3,3,0,0,0,11/15/2013,NMSU
Payaswini,3,3,0,0,0,11/15/2013,Radboud University Nijmegen
sten,3,3,0,0,0,11/19/2013,NMSU
apwastro55,3,3,0,0,0,11/22/2013,Columbia
lposti,3,3,0,0,0,11/26/2013,University of Bologna
Elisa,3,3,0,0,0,01/08/2014,University of Milano-Bicocca
esperlman,3,3,0,0,0,01/10/2014,Florida Tech
kaaret,3,3,0,0,0,01/12/2014,University of Iowa
mmalates,3,3,0,0,0,01/16/2014,University of Oklahoma
marriner,3,3,0,0,0,01/17/2014,Fermilab
Galaxygal,3,3,0,0,0,01/21/2014,University of Iowa
ansoldi,3,3,0,0,0,01/27/2014,Udine University
giuspugl,3,3,0,1,0,01/28/2014,SISSA
nmpingel,3,3,0,0,0,02/01/2014,WVU
jayanth,3,3,0,0,0,02/05/2014,WVU
rmor,3,3,0,0,0,02/17/2014,unaffiliated
iair,3,3,0,0,0,02/19/2014,LCOGT
jbyrne,3,3,0,0,0,02/20/2014,"IfA, University of Hawaii"
hchen,3,3,0,0,0,02/24/2014,NTHU
jhofgartner,3,3,0,0,3,02/24/2014,Cornell
mooratov,3,3,0,0,0,03/03/2014,UCSD
Jeremy Sakstein,3,3,0,1,0,03/11/2014,Perimeter Institute for Theoretical Physics
toad,3,3,0,1,0,03/21/2014,University of Hertfordshire
tholoien,3,3,0,0,0,03/24/2014,OSU Astronomy
jemejia,3,3,0,0,0,03/24/2014,UChile - Calan
Andrea Rojas,3,3,0,0,0,03/25/2014,UChile - Calan
mromero,3,3,0,0,0,03/27/2014,ICCUB
acoogan,3,3,0,0,0,04/03/2014,UCSC-HEP
wshepherd,3,3,0,0,0,04/04/2014,UCSC-HEP
bieri,3,3,0,0,0,04/07/2014,IAP Cosmology and Extragalactic
cmoutou,3,3,0,0,0,04/08/2014,CFHT
julienguy,3,3,0,0,0,04/16/2014,UCB
asherberlin,3,3,0,0,0,05/21/2014,Chicago-KICP
zephyr,3,3,0,0,0,07/21/2014,Boston University
mveyette,3,3,0,0,0,07/26/2014,Boston University
vcbusti,3,3,0,0,0,08/04/2014,UCT Cosmology
fbeutler,3,3,0,0,0,08/22/2014,UCB cosmology
Mastache,3,3,0,0,0,08/25/2014,U. Pittsburgh
Rebecca Tippens,3,3,0,0,0,08/28/2014,UT Austin
zx1882,3,3,0,0,0,08/30/2014,PMO
tbeatty,3,3,0,0,0,09/05/2014,Penn State
vansaders,3,3,0,0,0,09/05/2014,Carnegie
gkovacs,3,3,0,0,0,09/19/2014,Exoplanets@Cambridge
rmushotzky,3,3,0,0,0,09/24/2014,University of Maryland
nordhaus,3,3,0,0,0,09/25/2014,RIT-CCRG
RaffaellaMargutti,3,3,0,0,0,09/29/2014,Harvard ITC
deckert,3,3,0,0,0,10/02/2014,EPFL - UniGe
Cosmicstring,3,3,0,0,0,10/07/2014,AOB
tmonsue,3,3,0,0,0,10/07/2014,Vanderbilt
bcain,3,3,0,0,0,10/08/2014,UCD
sachin,3,3,0,0,0,11/04/2014,Cornell LEPP-STRINGS
alex.tudorica,3,3,0,0,0,11/05/2014,AIfA-Cosmo
jeffrey,3,3,0,0,0,11/05/2014,AIfA-Cosmo
zpace,3,3,0,0,0,11/07/2014,UW Madison
alexandros_ps,3,3,0,0,0,11/13/2014,University of Crete
duffell,3,3,0,0,0,11/13/2014,UCB
wkelly,3,3,0,0,0,11/14/2014,UCSB HEP/Gravity
Floriane,3,3,0,0,0,11/17/2014,CRAL
gshartnett,3,3,0,0,0,11/21/2014,UCSB HEP/Gravity
mcurti,3,3,0,0,0,12/01/2014,Osservatorio Astrofisico di Arcetri - Extragalactic
claudia.scoccola,3,3,0,0,0,12/01/2014,IALP-FCAGLP
octavio.guilera,3,3,0,0,0,12/01/2014,IALP-FCAGLP
gbaume,3,3,0,0,0,12/01/2014,IALP-FCAGLP
hitstapxdd,3,3,0,0,0,12/06/2014,HITS
Luke R,2,2,0,0,0,12/10/2009,UCSC
stefan24,2,2,0,0,0,07/07/2010,CIERA
Jean,2,2,0,0,0,07/09/2010,CIERA
jbloom,2,2,0,0,0,08/25/2010,UCB
glenn,2,2,0,0,0,11/11/2010,Caltech
jordibc,2,2,0,0,0,11/16/2010,Centro Nacional de Biotecnologia
dkaplan,2,2,0,0,0,11/29/2010,UW Milwaukee
Maryam shiarzi,2,2,0,0,0,12/02/2010,Leiden
gem,2,2,0,0,0,12/02/2010,CEA Saclay
acliu,2,2,0,0,0,12/10/2010,UCB
enectali,2,2,0,0,0,12/17/2010,MIT
evano,2,2,0,0,0,01/20/2011,UW Milwaukee
koshy,2,2,0,0,0,01/27/2011,Kapteyn
Sienny,2,2,0,0,0,02/01/2011,ASIAA
CVillforth,2,2,0,0,0,02/01/2011,University of Florida
dovi,2,2,0,0,0,02/02/2011,UCB
cubach,2,2,0,0,0,02/22/2011,Swinburne
jonathan,2,2,0,0,0,04/14/2011,IAS Orsay
gbrisebarre,2,2,0,0,0,04/19/2011,LAM
abrito,2,2,0,0,0,04/20/2011,PUC-Institute of Astrophysics
rdunner,2,2,0,0,0,04/27/2011,PUC-Institute of Astrophysics
MariaS,2,2,0,0,0,05/17/2011,DARK
jen,2,2,0,1,0,05/25/2011,UPenn
garyb,2,2,0,0,0,05/27/2011,UPenn
whitemc,2,2,0,0,0,06/05/2011,UW Milwaukee
nienke,2,2,0,0,0,06/16/2011,Leiden
Catrina Diener,2,2,0,0,0,06/22/2011,ETH-Extragalactic
westukiah,2,2,0,0,0,06/22/2011,Boston University
mbernet,2,2,0,0,0,06/24/2011,ETH-Extragalactic
moupiya,2,2,0,0,0,07/07/2011,IISc-RRI
bmiisc,2,2,0,0,0,07/08/2011,IISc-RRI
Matthew Hogan,2,2,0,0,0,08/15/2011,UCSC
nhinkel,2,2,0,0,0,08/18/2011,ASU Astro
sdelaney,2,2,0,0,0,08/23/2011,DIAS
meijerink,2,2,0,0,0,08/29/2011,Leiden
keatonb,2,2,0,0,0,08/29/2011,UT Austin
ruben,2,2,0,0,0,08/31/2011,ASIAA
rgalvan,2,2,0,0,0,09/08/2011,ESO Garching
wangsong,2,2,0,0,0,09/08/2011,unaffiliated
Luke Drury,2,2,0,0,0,09/13/2011,DIAS
wkwon,2,2,0,0,0,09/15/2011,UIUC-SF
moster,2,2,0,0,0,09/16/2011,MPA Garching
ajd2011,2,2,0,0,0,09/20/2011,Rutgers
Morgane,2,2,0,0,0,09/23/2011,IAS Orsay
pradel,2,2,0,0,0,09/28/2011,ASIAA
JJ,2,2,0,0,0,10/12/2011,MPA Garching
wagner,2,2,0,0,0,10/13/2011,Valongo Observatory
vbuat,2,2,0,0,0,10/14/2011,LAM
Jessica,2,2,0,0,0,10/17/2011,IAS Orsay
RochaPinto,2,2,0,0,0,10/20/2011,Valongo Observatory
meiling,2,2,0,0,0,10/20/2011,MPA Garching
DAstronomer,2,2,0,0,0,10/31/2011,University of Florida
jlwalsh,2,2,0,0,0,11/02/2011,Texas A&M
sninkovic,2,2,0,0,0,11/22/2011,AOB
tdavid,2,2,0,0,0,12/02/2011,Caltech
dyas,2,2,0,0,0,12/22/2011,UCB
fanxiaohui,2,2,0,0,0,01/16/2012,Arizona
gregghallinan,2,2,0,0,0,01/18/2012,Caltech
Rajeev Jain,2,2,0,0,0,02/15/2012,Geneva Cosmology Group
Tomomi S,2,2,0,0,0,02/22/2012,Yale
dpodolsky,2,2,0,0,0,02/28/2012,unaffiliated
Aden,2,2,0,0,0,03/02/2012,Georgia Tech
Isabel,2,2,0,0,0,03/06/2012,CEA Saclay High Energy
drb,2,2,0,0,0,03/07/2012,Georgia Tech
sfnewman,2,2,0,0,0,03/07/2012,UCB
dguery,2,2,0,0,0,03/26/2012,IAS Orsay
Andreas Fueglistaler,2,2,0,0,0,03/29/2012,EPFL - UniGe
CSteinhardt,2,2,0,0,0,03/30/2012,Kavli IPMU
monisia,2,2,0,0,0,03/31/2012,UNLV
quimby,2,2,0,0,0,04/06/2012,Kavli IPMU
agaspar,2,2,0,0,0,04/11/2012,Arizona
julian.adamek,2,2,0,0,0,04/12/2012,Geneva Cosmology Group
nefinia,2,2,0,0,0,04/17/2012,PUC-Institute of Astrophysics
antonellini,2,2,0,0,0,05/04/2012,Kapteyn
rosa,2,2,0,0,0,06/05/2012,IATE
timw,2,2,0,0,0,06/06/2012,UT Austin
pawlik,2,2,0,0,0,04/21/2014,MPA Garching
dolon,2,2,0,0,0,06/20/2012,Boston University
pmollitor,2,2,0,0,0,06/26/2012,LAM
hcosmosb,2,2,0,0,0,06/28/2012,UT Austin
hadi,2,2,0,0,0,08/10/2012,IUCAA
gwolfchase,2,2,0,0,0,08/24/2012,Adler Planetarium
krishna,2,2,0,0,0,08/29/2012,IUCAA
cleevesli,2,2,0,0,0,09/04/2012,U. Michigan
brittany kamai,2,2,0,0,0,09/04/2012,Chicago-KICP
Triana Almeyda,2,2,0,0,0,09/09/2012,RIT
dbb2737,2,2,0,0,0,09/10/2012,RIT-CCRG
siverd,2,2,0,0,0,09/10/2012,LCOGT
Vicente,2,2,0,0,0,09/17/2012,Harvard ITC
mmortonson,2,2,0,0,0,09/17/2012,UCB
jlpipher,2,2,0,0,0,09/20/2012,University of Rochester
mpecaut,2,2,0,0,0,09/21/2012,University of Rochester
khkim,2,2,0,0,0,09/24/2012,University of Rochester
Schurch,2,2,0,0,0,09/25/2012,Stanford
yoshi,2,2,0,0,0,09/25/2012,Stanford
lchamandy,2,2,0,0,0,09/27/2012,IUCAA
burchat,2,2,0,0,0,09/28/2012,Stanford
mdwood,2,2,0,0,0,09/28/2012,Stanford
Steve,2,2,0,0,0,10/02/2012,PUC-Institute of Astrophysics
jsteffen,2,2,0,0,0,10/02/2012,CIERA
jumbrown,2,2,0,0,2,10/03/2012,UCSC
raab,2,2,0,0,0,10/12/2012,Edinburgh
adastragrl,2,2,0,0,0,10/15/2012,University of Maryland
snickers,2,2,0,0,0,10/16/2012,Zürich
ossokine,2,2,0,0,0,10/16/2012,UofT
relliotmeyer,2,2,0,0,0,10/16/2012,UofT
rclivermore,2,2,0,0,0,10/17/2012,UT Austin
Adam Stewart,2,2,0,0,0,10/18/2012,University of Southampton
ddeming,2,2,0,0,0,10/19/2012,University of Maryland
adempsey,2,2,0,0,0,10/19/2012,CIERA
jineson,2,2,0,0,0,10/22/2012,University of Southampton
sdouglas,2,2,0,0,0,10/25/2012,Columbia
plk,2,2,0,0,0,10/25/2012,UCB
dekel,2,2,0,0,0,10/31/2012,Hebrew University
tuguldur,2,2,0,0,5,11/07/2012,UCSC
lyh,2,2,0,0,0,11/07/2012,"IfA, University of Hawaii"
mdecesar,2,2,0,0,0,11/09/2012,University of Maryland
timstaley,2,2,0,0,0,11/09/2012,unaffiliated
kerrm,2,2,0,0,0,11/13/2012,Stanford
nzamora,2,2,0,0,0,11/19/2012,University of Chile-DFI
amantz,2,2,0,0,0,11/28/2012,Chicago-KICP
willvousden,2,2,0,0,0,11/29/2012,University of Birmingham
seanjohnson,2,2,0,0,0,11/29/2012,Chicago-KICP
pcamps,2,2,0,0,0,12/03/2012,Ghent University
eotto,2,2,0,0,0,12/10/2012,UCSC
João Faria,2,2,0,0,0,01/15/2013,CAUP
fgomez,2,2,0,0,0,01/15/2013,Michigan State
bobs,2,2,0,0,0,01/16/2013,Michigan State
grisaliti,2,2,0,0,0,01/18/2013,Osservatorio Astrofisico di Arcetri - Extragalactic
Jonatan,2,2,0,0,0,01/19/2013,Universidad de Costa Rica
Kevin Gonzalez,2,2,0,0,0,01/23/2013,Universidad de Costa Rica
fgautier,2,2,0,0,0,01/23/2013,APC
prava,2,2,0,0,0,01/26/2013,IIA
luisfer,2,2,0,0,0,01/28/2013,UniGoettingen
Juan Carlos,2,2,0,0,0,01/29/2013,NRAO Charlottesville
Gerardo Salazar,2,2,0,0,0,01/31/2013,Universidad de Costa Rica
al.istrate,2,2,0,0,0,02/06/2013,AIfA
hsshih,2,2,0,0,0,02/11/2013,"IfA, University of Hawaii"
bleeml,2,2,0,0,0,03/02/2013,Chicago-KICP
veronica,2,2,0,0,0,03/04/2013,INAF-OAR
yanny,2,2,0,0,0,03/04/2013,Fermilab
jrich,2,2,0,0,0,03/05/2013,Carnegie
abray,2,2,0,0,0,03/11/2013,Harvard ITC
tom,2,2,0,0,0,04/03/2013,"U. de Concepcion: Planetary, Stellar, Galactic, Extragalactic papers"
cgiocoli,2,2,0,0,0,04/08/2013,University of Bologna
lorenamz,2,2,0,0,0,04/10/2013,Georgia Tech
haruki.nishino,2,2,0,0,0,05/09/2013,Kavli IPMU
Matteo Barnabe,2,2,0,0,0,05/09/2013,DARK
lizinvt,2,2,0,0,0,05/15/2013,UCB
cmarvin,2,2,0,0,0,05/28/2013,UniGoettingen
aribrill,2,2,0,0,0,05/31/2013,Yale-Planets
Gwenaël Boué,2,2,0,0,0,06/04/2013,Chicago-KICP
dgeisler,2,2,0,0,0,06/10/2013,"U. de Concepcion: Planetary, Stellar, Galactic, Extragalactic papers"
Elvis Soares,2,2,0,0,0,06/12/2013,UFRJ
Manuel Merello,2,2,0,0,0,07/25/2013,UT Austin
nbonne,2,2,0,0,0,08/07/2013,MoCA
xhsun,2,2,0,0,0,08/22/2013,SIfA
Beau,2,2,0,0,0,08/22/2013,SIfA
maestro,2,2,0,0,0,08/26/2013,SIfA
yaolun,2,2,0,0,0,08/28/2013,UT Austin
mulders,2,2,0,0,0,08/29/2013,Arizona
Mattia Vaccari,2,2,0,0,0,09/03/2013,UWC
frolov,2,2,0,0,0,09/11/2013,SFU
avang,2,2,0,0,0,09/16/2013,UW Madison
thaines,2,2,0,0,0,09/16/2013,UW Madison
Kathy Romer,2,2,0,0,0,09/19/2013,"U. of Sussex, Astronomy Centre"
mwolf,2,2,0,0,0,09/20/2013,UW Madison
heinzs,2,2,0,0,0,09/25/2013,UW Madison
OwenLittlejohns,2,2,0,0,0,09/25/2013,ASU Astro
jdownes,2,2,0,0,0,09/26/2013,IA-UNAM Ensenada
abostrom,2,2,0,0,0,09/27/2013,University of Maryland
brianpschmidt,2,2,0,0,0,09/30/2013,RSAA-ANU
mozbek,2,2,0,0,0,09/30/2013,Carnegie Mellon University
ELofthouse,2,2,0,0,0,10/02/2013,University of Hertfordshire
tbrown,2,2,0,0,0,10/04/2013,STScI/JHU
kluhman,2,2,0,0,0,10/07/2013,Penn State
Joel Roediger,2,2,0,0,3,10/07/2013,UCSC
ohk,2,2,0,0,0,10/10/2013,ETH-Extragalactic
ozamora,2,2,0,0,0,10/11/2013,IAC
astroyorch,2,2,0,0,0,10/14/2013,IAC
Martin van den Akker,2,2,0,0,0,10/15/2013,Radboud University Nijmegen
pwright,2,2,0,0,0,10/16/2013,Harvard ITC
churun,2,2,0,0,0,10/17/2013,Nanjing University
wic,2,2,0,0,0,10/23/2013,Durham University
rkeisler,2,2,0,0,0,10/25/2013,Stanford
jdsloane,2,2,0,0,0,11/01/2013,Rutgers
caius,2,2,0,0,0,11/05/2013,IAC
rik,2,2,0,0,0,11/05/2013,University of Amsterdam
Riley,2,2,0,0,0,11/05/2013,University of Amsterdam
bosken,2,2,0,2,0,11/13/2013,US Naval Observatory
dijon,2,2,0,0,0,11/14/2013,Radboud University Nijmegen
almog.yalin,2,2,0,0,0,11/20/2013,Hebrew University
srf,2,2,0,0,0,11/20/2013,SAC
artemi,2,2,0,0,0,11/21/2013,IAC
qminor,2,2,0,0,0,11/25/2013,AMNH
JimmyLing,2,2,0,0,0,12/03/2013,NAOC
spirou,2,2,0,0,0,12/20/2013,University of Heidelberg ITP/ITA
audley,2,2,0,0,0,01/02/2014,SRON Groningen
jcybulsk,2,2,0,0,0,01/05/2014,UMass Amherst
thutchinson,2,2,0,0,0,01/09/2014,University of Utah
teppei.okumura,2,2,0,0,0,01/14/2014,Kavli IPMU
aliciabueno,2,2,0,0,0,01/14/2014,University of Heidelberg ITP/ITA
viel,2,2,0,0,0,01/15/2014,OATS
fuhrer,2,2,0,0,0,01/17/2014,University of Heidelberg ITP/ITA
Evan Abbuhl,2,2,0,0,0,01/21/2014,University of Iowa
tsk99,2,2,0,0,0,01/22/2014,OATS
msimonov,2,2,0,0,0,01/27/2014,SISSA
carlson,2,2,0,0,0,01/28/2014,UCSC-HEP
mcalabre,2,2,0,0,0,01/28/2014,SISSA
MarkWalker,2,2,0,0,0,02/02/2014,Oxford University - Galaxies
jmparedes,2,2,0,0,0,02/04/2014,ICCUB
abunker1,2,2,0,0,0,02/05/2014,Oxford University - Galaxies
Markos Georganopoulos,2,2,0,0,0,02/05/2014,STScI-AGN
gecortes,2,2,0,0,0,02/06/2014,Cornell
mwhosek,2,2,0,0,0,02/07/2014,"IfA, University of Hawaii"
AstroKatie,2,2,0,0,0,02/10/2014,University of Melbourne
nagrogin,2,2,0,1,0,02/10/2014,STScI-AGN
aagnello,2,2,0,0,0,02/11/2014,UCSB
stmcwilliams,2,2,0,0,0,02/20/2014,WVU
hfhsieh,2,2,0,0,0,02/24/2014,NTHU
Yongbeom,2,2,0,0,0,02/26/2014,KASI
jameshhchan,2,2,0,0,0,02/27/2014,ASIAA
CHerron,2,2,0,0,0,03/12/2014,SIfA
scodis,2,2,0,0,0,03/17/2014,IAP Cosmology and Extragalactic
gallis,2,2,0,0,0,03/17/2014,IAP Cosmology and Extragalactic
clanton,2,2,0,0,0,03/23/2014,OSU Astronomy
weipeng,2,2,0,0,0,03/24/2014,NTHU
astroclemson,2,2,0,0,0,03/28/2014,Clemson
Ben Shappee,2,2,0,0,0,03/31/2014,Carnegie
AnastasiaPonomareva,2,2,0,0,0,04/01/2014,Kapteyn-HI
kjelise,2,2,0,0,0,04/02/2014,Chicago-KICP
AlmaX,2,2,0,0,0,04/07/2014,UCSC-HEP
scadams,2,2,0,0,0,04/14/2014,Clemson
ccortis,2,2,0,0,0,04/14/2014,Clemson
Martin Gaskell,2,2,0,1,0,04/22/2014,UCSC
jmitch,2,2,0,0,0,05/02/2014,AIfA
ddenis,2,2,0,0,0,05/27/2014,FSU Astrophysics
beth.stetzler,2,2,0,0,0,05/29/2014,University of Oklahoma
hirokazu,2,2,0,0,0,06/03/2014,DARK
cmaitra,2,2,0,0,0,06/04/2014,CEA Saclay High Energy
caglasu,2,2,0,0,0,06/08/2014,Istanbul University
Luther,2,2,0,0,0,06/09/2014,U. Pittsburgh
Eda Gjergo,2,2,0,0,0,07/07/2014,U. Pittsburgh
Louise Daniels,2,2,0,0,0,07/07/2014,UCR
connorr,2,2,0,0,0,07/09/2014,Boston University
Szymon,2,2,0,0,0,07/10/2014,University of Southampton
jianwei,2,2,0,0,0,08/15/2014,Arizona
rybrennan,2,2,0,0,0,08/31/2014,Rutgers
lnofi,2,2,0,0,0,09/08/2014,"IfA, University of Hawaii"
Valerio Marra,2,2,0,0,0,09/11/2014,UFES Cosmology
jwhenning,2,2,0,0,0,09/11/2014,Chicago-KICP
cwh,2,2,0,0,0,09/12/2014,UCT Cosmology
gyzhao,2,2,0,0,0,09/15/2014,KASI
sbongio3,2,2,0,0,0,09/16/2014,Johns Hopkins
stefanoprofumo,2,2,0,0,0,09/18/2014,UCSC
Sijme-Jan,2,2,0,0,0,09/19/2014,Exoplanets@Cambridge
rasmush,2,2,0,0,0,09/23/2014,SAC
bhayden,2,2,0,0,0,09/23/2014,UCB cosmology
scichris,2,2,0,0,0,09/24/2014,University of Washington
jscudder,2,2,0,0,0,09/25/2014,"U. of Sussex, Astronomy Centre"
jill.naiman,2,2,0,0,0,09/29/2014,Harvard ITC
elisachisari,2,2,0,0,0,10/03/2014,Oxford University - Galaxies
Ant_Jones,2,2,0,0,0,10/05/2014,IAS Orsay - ISM
mardling,2,2,0,0,0,10/08/2014,MoCA
lapo.fanciullo,2,2,0,0,0,10/13/2014,IAS Orsay - ISM
mkorsaga,2,2,0,0,0,10/15/2014,LAM
sakohn,2,2,0,0,0,10/21/2014,UPenn
jguzik,2,2,0,0,0,10/23/2014,LANL
zmedin,2,2,0,0,0,10/23/2014,LANL
Bill Priedhorsky,2,2,0,0,0,10/23/2014,LANL
mstockmann,2,2,0,0,0,10/24/2014,DARK
jfgonzal,2,2,0,0,0,10/24/2014,CRAL
giladsv,2,2,0,0,0,10/27/2014,Hebrew University
Yuying,2,2,0,0,0,11/05/2014,AIfA-Cosmo
Ed Macaulay,2,2,0,0,0,11/11/2014,UQ Swinburne Cosmology
Sofiatti,2,2,0,0,0,11/11/2014,UCB cosmology
Justin Wu,2,2,0,0,0,11/24/2014,NTHU
guille,2,2,0,0,0,12/01/2014,IALP-FCAGLP
carpintero,2,2,0,0,0,12/02/2014,IALP-FCAGLP
sergio,2,2,0,0,0,12/02/2014,IALP-FCAGLP
Hilal,2,2,0,0,0,12/09/2014,Istanbul University
ed.celik,2,2,0,0,0,12/10/2014,Istanbul University
Patrik,1,1,0,0,0,07/29/2009,MIT
Fulai,1,1,0,0,6,09/03/2009,UCSC
Xian,1,1,0,0,0,10/21/2009,PKU
Eliza,1,1,0,0,2,10/29/2009,UCSC
Mark Mozena,1,1,0,0,2,11/19/2009,UCSC
gparm,1,1,0,0,0,07/13/2010,AIfA
Fermi,1,1,0,0,0,07/14/2010,CIERA
lstrubbe,1,1,0,0,0,08/25/2010,UCB
joung,1,1,0,0,0,09/08/2010,Columbia
mmontero,1,1,0,0,0,09/14/2010,Columbia
jaburt,1,1,0,0,2,09/14/2010,UCSC
joanne,1,1,0,0,0,09/21/2010,UCB
Rory,1,1,0,0,0,09/22/2010,CIERA
belinda,1,1,0,2,0,09/24/2010,HEAD-CfA
moritz,1,1,0,0,0,10/01/2010,HEAD-CfA
etc,1,1,0,0,0,10/06/2010,CIERA
OKing,1,1,0,0,0,10/26/2010,Caltech
manulinares,1,1,0,0,0,11/09/2010,IAC
jsdillon,1,1,0,0,0,11/09/2010,MIT
mkistler,1,1,0,0,0,11/11/2010,Stanford
leonard,1,1,0,0,0,11/16/2010,UW Milwaukee
neill,1,1,0,0,0,11/19/2010,Caltech
Rottgering,1,1,0,0,0,12/01/2010,Leiden
pvdwerf,1,1,0,0,0,12/02/2010,Leiden
rmalina,1,1,0,0,0,12/15/2010,LAM
andrea,1,1,0,0,0,01/18/2011,LAM
matthewturk,1,1,0,0,0,01/25/2011,Columbia
jmd,1,1,0,0,0,02/01/2011,LAM
Selma de Mink,1,1,0,0,0,02/04/2011,STScI/JHU
Edith,1,1,0,0,0,02/09/2011,Leiden
fvalsecchi,1,1,0,0,0,02/14/2011,CIERA
chrisusher,1,1,0,0,0,02/18/2011,Swinburne
fpignatale,1,1,0,0,0,02/22/2011,CRAL
abhaygshah,1,1,0,0,0,02/22/2011,UW Milwaukee
ctonini,1,1,0,0,0,03/10/2011,Swinburne
loqueelviento,1,1,0,0,0,03/26/2011,PUC-Institute of Astrophysics
ntaburet,1,1,0,0,0,04/12/2011,IAS Orsay
Roozbeh,1,1,0,0,0,04/13/2011,UCR
megan.bagley,1,1,0,0,0,04/20/2011,Arizona
jaynebirkby,1,1,0,0,0,04/29/2011,Leiden
Alex,1,1,0,0,0,05/10/2011,IAS Orsay
idm,1,1,0,0,0,05/18/2011,Arizona
harab,1,1,0,0,0,05/23/2011,IAS Orsay
mSalem,1,1,0,0,0,05/31/2011,Columbia
ronie,1,1,0,0,0,06/22/2011,ETH-Extragalactic
Paloma,1,1,0,0,0,06/24/2011,PUC-Institute of Astrophysics
Matteo85,1,1,0,0,0,07/01/2011,DARK
karto,1,1,0,0,0,07/06/2011,UCB
mjarvis,1,1,0,0,0,07/22/2011,UPenn
kschluns,1,1,0,0,0,07/27/2011,UT Austin
fminiati,1,1,0,0,0,08/10/2011,ETH-Extragalactic
benjaminlackey,1,1,0,0,0,08/10/2011,UW Milwaukee
andres_alejandro,1,1,0,0,0,08/18/2011,UPenn
dac,1,1,0,0,0,08/22/2011,DIAS
scowen,1,1,0,0,0,08/22/2011,ASU Astro
kyle,1,1,0,0,0,08/22/2011,UofT
scannapieco,1,1,0,0,0,08/23/2011,ASU Astro
hiro,1,1,0,0,0,08/31/2011,ASIAA
bdmetzger,1,1,0,0,0,09/02/2011,unaffiliated
Kjell Eriksson,1,1,0,0,0,09/02/2011,Uppsala
ipbldqi,1,1,0,0,0,09/09/2011,unaffiliated
Nicolas Perez,1,1,0,0,0,09/09/2011,PUC-Institute of Astrophysics
Cséki Attila,1,1,0,0,0,09/15/2011,AOB
Zhu Wei,1,1,0,0,0,09/18/2011,unaffiliated
XJ Zhang,1,1,0,0,0,09/19/2011,unaffiliated
nicoviaux,1,1,0,0,0,09/20/2011,PUC-Institute of Astrophysics
leitherer,1,1,0,0,0,09/21/2011,STScI/JHU
guillot,1,1,0,0,0,09/22/2011,UCSC
augusto,1,1,0,0,0,09/27/2011,UT Austin
akuznet1,1,1,0,0,0,09/27/2011,UCSC
Columbia,1,1,0,0,0,09/27/2011,Columbia
cthom,1,1,0,0,0,10/05/2011,STScI/JHU
indrani,1,1,0,0,0,10/07/2011,IISc-RRI
mbothwell,1,1,0,0,0,10/12/2011,Arizona
themis,1,1,0,0,0,10/13/2011,ASU Astro
listerstaveleysmith,1,1,0,0,0,10/14/2011,ICRAR
lwen,1,1,0,0,0,10/19/2011,ICRAR
Attila,1,1,0,0,0,10/20/2011,ICRAR
deepstardust,1,1,0,0,0,10/26/2011,unaffiliated
ajtownsend,1,1,0,0,0,10/28/2011,University of Florida
mjpayne,1,1,0,0,0,10/28/2011,University of Florida
sctrager,1,1,0,0,0,11/02/2011,Kapteyn
dani,1,1,0,0,0,11/08/2011,University of Vienna
emhuff,1,1,0,0,0,11/08/2011,UCB
alangarner,1,1,0,0,0,11/22/2011,University of Florida
jdejong,1,1,0,0,0,11/28/2011,Leiden-NOLG
Zeinab,1,1,0,0,0,11/29/2011,AIfA-Cosmo
schmassmann,1,1,0,0,0,11/30/2011,ETH-Extragalactic
juel,1,1,0,0,0,12/12/2011,DARK
bfrye,1,1,0,0,0,01/13/2012,Arizona
bedregal,1,1,0,0,1,01/17/2012,UMN
Sinziana Paduroiu,1,1,0,0,0,01/25/2012,EPFL - UniGe
soojong,1,1,0,0,0,01/25/2012,UT Austin
edwinkite,1,1,0,0,0,02/05/2012,Caltech
Enea,1,1,0,0,0,02/16/2012,Geneva Cosmology Group
mona,1,1,0,0,0,02/17/2012,Geneva Cosmology Group
Felix.Mirabel,1,1,0,0,0,02/28/2012,CEA Saclay
Nicolas,1,1,0,0,0,03/02/2012,CEA Saclay High Energy
plaguna,1,1,0,0,0,03/05/2012,Georgia Tech
Natalie Horvath,1,1,0,0,0,03/06/2012,UNLV
daughjd,1,1,0,0,0,03/07/2012,Georgia Tech
tomas,1,1,0,0,0,03/19/2012,PUC-Institute of Astrophysics
yukawa,1,1,0,0,0,03/28/2012,AOB
Edgar Mendoza,1,1,0,0,0,03/29/2012,Valongo Observatory
takahiro,1,1,0,0,0,03/30/2012,IAP Cosmology and Extragalactic
lukicdv,1,1,0,0,0,04/06/2012,AOB
tdincer,1,1,0,0,0,04/09/2012,Sabanci University
sloanew,1,1,0,0,5,04/24/2012,UCSC
rcdannen,1,1,0,0,0,05/11/2012,UNLV
Harriet Dinerstein,1,1,0,0,0,05/16/2012,UT Austin
ielm,1,1,0,0,0,05/18/2012,MIT
Doug,1,1,0,0,0,05/25/2012,ICS
mschramm,1,1,0,0,0,06/29/2012,Kavli IPMU
Dominik,1,1,0,0,0,07/05/2012,AIfA-Cosmo
matteoc,1,1,0,0,0,07/09/2012,DARK
astrom,1,1,0,0,0,07/17/2012,Caltech
mataylor,1,1,0,0,0,07/19/2012,PUC-Institute of Astrophysics
maureenteyssier,1,1,0,0,0,08/06/2012,Columbia
mayorofdetroit,1,1,0,0,0,08/07/2012,MIT
aurora,1,1,0,0,0,08/09/2012,Stanford
ligj,1,1,0,0,0,08/13/2012,Harvard ITC
adityarotti,1,1,0,0,0,08/19/2012,FSU Astrophysics
wlim,1,1,0,0,0,08/20/2012,University of Florida
LarryCiupik,1,1,0,0,0,08/23/2012,Adler Planetarium
msubbarao,1,1,0,0,0,08/24/2012,Adler Planetarium
evelee,1,1,0,0,0,08/28/2012,UCB
nsanders,1,1,0,0,0,08/29/2012,Harvard ITC
Phillip MacQueen,1,1,0,0,0,08/30/2012,UT Austin
kstassun,1,1,0,0,0,09/04/2012,Vanderbilt
mlcomins,1,1,0,0,0,09/04/2012,Cornell
Yuan-Sen Ting,1,1,0,0,0,09/05/2012,unaffiliated
cslater,1,1,0,0,0,09/05/2012,U. Michigan
chenyf,1,1,0,1,0,09/15/2012,PKU
jblazek,1,1,0,0,0,09/17/2012,UCB
michael,1,1,0,0,0,09/19/2012,UIUC
Jeff.Hazboun,1,1,0,0,0,09/21/2012,Georgia Tech
erykoff,1,1,0,0,0,09/25/2012,Stanford
brodie,1,1,0,0,0,09/26/2012,UCSC
rferdman,1,1,0,0,0,09/26/2012,McGill
Nimish Hathi,1,1,0,0,0,09/26/2012,LAM
Raquel,1,1,0,0,0,10/01/2012,Valongo Observatory
kaylanb,1,1,0,0,0,10/02/2012,UCB
knoeske,1,1,0,0,0,10/02/2012,STScI/JHU
ondrej,1,1,0,0,0,10/04/2012,Stanford
Ari,1,1,0,0,0,10/09/2012,Stanford
sclouse,1,1,0,0,0,10/09/2012,UIUC
tucci,1,1,0,0,0,10/17/2012,Geneva Cosmology Group
RobPerry,1,1,0,0,0,10/17/2012,Durham University
gmarozzi,1,1,0,0,0,10/17/2012,Geneva Cosmology Group
Jodie,1,1,0,0,0,10/18/2012,Vanderbilt
soko,1,1,0,0,0,10/18/2012,University of Maryland
kristalynne,1,1,0,0,0,10/18/2012,University of Maryland
kevinkrisciunas,1,1,0,0,1,10/18/2012,Texas A&M
irs,1,1,0,0,0,10/19/2012,Durham University
asante,1,1,0,0,0,10/24/2012,UCI
jdmeyer,1,1,0,0,0,10/25/2012,Columbia
azzollini,1,1,0,0,0,10/25/2012,DIAS
huji_astro,1,1,0,0,0,10/30/2012,Hebrew University
jrj1g09,1,1,0,0,0,10/31/2012,University of Southampton
Yuval Birnboim,1,1,0,0,0,10/31/2012,Hebrew University
cdegraf,1,1,0,0,0,10/31/2012,Hebrew University
alejocosmico,1,1,0,0,0,11/02/2012,Columbia
yx,1,1,0,0,0,11/03/2012,"IfA, University of Hawaii"
hcraig,1,1,0,0,0,11/06/2012,Stanford
nathankaib,1,1,0,0,0,11/06/2012,CIERA
shorbool,1,1,0,0,0,11/14/2012,PKU
pratika24,1,1,0,0,0,11/14/2012,Edinburgh
scespede,1,1,0,0,0,11/16/2012,University of Chile-DFI
beckermr,1,1,0,0,0,11/16/2012,Stanford
silburt,1,1,0,0,0,11/16/2012,UofT
white,1,1,0,0,0,11/16/2012,UofT
angeles19531322,1,1,0,0,0,11/18/2012,University of Chile-DFI
cardwell,1,1,0,0,0,11/21/2012,Gemini-South
storres,1,1,0,0,0,11/21/2012,Gemini-South
TJoseph,1,1,0,0,0,11/21/2012,University of Southampton
KBarrera,1,1,0,0,0,11/30/2012,University of Chile-DFI
jbroderick,1,1,0,0,0,12/04/2012,University of Southampton
Pallavi,1,1,0,0,0,12/14/2012,IUCAA
jetosip,1,1,0,0,0,12/18/2012,Gemini-South
Guillaume,1,1,0,0,0,01/10/2013,APC
Alpízar,1,1,0,0,0,01/17/2013,Universidad de Costa Rica
sacohen,1,1,0,0,0,01/22/2013,Dartmouth College
izhur,1,1,0,0,0,01/22/2013,Stanford
Idan Ginsburg,1,1,0,0,0,01/23/2013,Dartmouth College
KevinHainline,1,1,0,0,0,01/31/2013,Dartmouth College
gid,1,1,0,0,0,02/04/2013,"IfA, University of Hawaii"
as,1,1,0,0,0,02/04/2013,"IfA, University of Hawaii"
dudleyj,1,1,0,0,0,02/05/2013,McGill
kilanel,1,1,0,0,0,02/07/2013,University of Birmingham
kscott80,1,1,0,0,0,02/07/2013,NRAO Charlottesville
rathna,1,1,0,0,0,02/11/2013,IIA
pradeepch,1,1,0,0,0,02/12/2013,IIA
stalin,1,1,0,0,0,02/12/2013,IIA
Gabriel,1,1,0,0,0,02/12/2013,UNLV
hxx800,1,1,0,0,0,02/12/2013,STScI/JHU
dmargala,1,1,0,0,0,02/14/2013,UCI
hf,1,1,0,0,0,02/14/2013,"IfA, University of Hawaii"
andrea tartari,1,1,0,0,0,02/15/2013,APC
sarahsalviander,1,1,0,0,0,02/20/2013,UT Austin
dr,1,1,0,0,0,02/25/2013,Cornell
finley,1,1,0,1,0,02/28/2013,Fermilab
iliasc,1,1,0,0,0,02/28/2013,Fermilab
kamath,1,1,0,0,0,03/11/2013,IIA
basilio,1,1,0,0,0,03/19/2013,UCI
Caddy,1,1,0,0,0,03/21/2013,"U. de Concepcion: Planetary, Stellar, Galactic, Extragalactic papers"
manal,1,1,0,0,0,03/25/2013,CEA Saclay
eschwiet,1,1,0,0,0,04/01/2013,University of Washington
kjani3,1,1,0,0,0,04/02/2013,Georgia Tech
nardini,1,1,0,0,0,04/03/2013,University of Milano-Bicocca
smitha,1,1,0,0,0,04/04/2013,IIA
rpwilliams,1,1,0,0,0,04/16/2013,LJMU
gx,1,1,0,0,0,04/24/2013,University of Southampton
BenneHolwerda,1,1,0,0,0,04/25/2013,Leiden
buckley,1,1,0,0,0,05/06/2013,Fermilab
vargas,1,1,0,0,0,05/17/2013,UFRJ
apicard,1,1,0,0,0,05/24/2013,Yale-Planets
mkephart,1,1,0,0,0,05/28/2013,Yale-Planets
jrigby,1,1,0,0,0,05/29/2013,NASA Goddard Space Flight Center
kirstenh,1,1,0,0,0,06/03/2013,Rutgers
auribe,1,1,0,0,0,06/04/2013,Chicago-KICP
berge,1,1,0,0,0,06/07/2013,GRAPPA Institute
petiay,1,1,0,0,0,06/07/2013,University of Washington
rishikhatri,1,1,0,0,0,06/12/2013,unaffiliated
j.patrick.h,1,1,0,0,0,06/20/2013,University of Maryland
raulpuebla,1,1,0,0,0,06/20/2013,U. Pittsburgh
dainotti,1,1,0,1,1,06/20/2013,Stanford
wrutter,1,1,0,0,0,06/25/2013,Yale-Planets
grigoris,1,1,0,0,0,06/28/2013,University of Chile-DFI
klabrie,1,1,0,0,0,07/09/2013,Gemini-North
rjorgenson,1,1,0,0,0,07/22/2013,"IfA, University of Hawaii"
gangelou,1,1,0,0,0,07/26/2013,MoCA
schenker,1,1,0,0,0,07/26/2013,Caltech
jbuntain,1,1,0,0,0,07/29/2013,MoCA
mjibrown,1,1,0,0,0,07/29/2013,MoCA
vdorazi,1,1,0,0,0,08/08/2013,MoCA
Adam Schaefer,1,1,0,0,0,08/22/2013,SIfA
christhechris,1,1,0,0,0,08/22/2013,SIfA
samuelnathanrichards,1,1,0,0,0,08/26/2013,SIfA
bgaensler,1,1,0,0,0,08/26/2013,SIfA
btd123,1,1,0,0,0,08/26/2013,Vanderbilt
caldervf,1,1,0,0,0,08/26/2013,Vanderbilt
windbinderue,1,1,0,0,0,08/28/2013,UT Austin
stevans,1,1,0,0,0,08/29/2013,UT Austin
EHampton,1,1,0,0,0,09/02/2013,RSAA-ANU
sinukoff,1,1,0,0,0,09/04/2013,"IfA, University of Hawaii"
kuehn,1,1,0,0,0,09/05/2013,SIfA
drity_k,1,1,0,0,0,09/09/2013,U. Pittsburgh
damo,1,1,0,0,0,09/11/2013,UPenn
bsmart,1,1,0,0,0,09/17/2013,UW Madison
iliev,1,1,0,0,0,09/18/2013,"U. of Sussex, Astronomy Centre"
fliu,1,1,0,0,0,09/18/2013,RSAA-ANU
tremonti,1,1,0,0,0,09/20/2013,UW Madison
Camille L.,1,1,0,0,1,09/23/2013,UCSC
shalverson,1,1,0,0,0,09/23/2013,Penn State
dbarringer,1,1,0,0,0,09/23/2013,Penn State
milliman,1,1,0,0,0,09/25/2013,UW Madison
saskia,1,1,0,0,0,09/26/2013,UniGoettingen
bdennis,1,1,0,0,0,09/26/2013,NASA Goddard Space Flight Center
noroozian,1,1,0,0,0,09/26/2013,NASA Goddard Space Flight Center
stephaniehho,1,1,0,0,0,10/01/2013,UCSB
olk,1,1,0,0,0,10/01/2013,"U. of Sussex, Astronomy Centre"
Alan,1,1,0,0,0,10/02/2013,CEA Saclay High Energy
jmrespinosa,1,1,0,0,0,10/03/2013,IAC
hdeeg,1,1,0,0,0,10/03/2013,IAC
cjackman,1,1,0,0,0,10/03/2013,University of Southampton
Graham Thompson,1,1,0,0,0,10/04/2013,University of Hertfordshire
geraldrude,1,1,0,0,0,10/05/2013,UCR
carme,1,1,0,0,0,10/07/2013,IAC
gregory.romine,1,1,0,0,0,10/07/2013,Penn State
mauricio,1,1,0,0,0,10/07/2013,IAC
msimet,1,1,0,0,0,10/07/2013,Carnegie Mellon University
Sownak,1,1,0,0,0,10/08/2013,Durham University
peter.r.mccullough,1,1,0,0,0,10/11/2013,STScI/JHU
suvrath,1,1,0,0,0,10/11/2013,Penn State
Nacho,1,1,0,0,0,10/11/2013,IAC
thuard,1,1,0,0,0,10/11/2013,University of Maryland
jh,1,1,0,0,0,10/14/2013,University of Exeter
ExoSing,1,1,0,0,0,10/14/2013,University of Exeter
mbayliss,1,1,0,0,0,10/18/2013,Harvard ITC
jennyee,1,1,0,0,0,10/18/2013,Harvard ITC
heggie,1,1,0,0,0,10/23/2013,IHP
leandro.beraldo,1,1,0,0,0,10/24/2013,IHP
PaddyAlton,1,1,0,0,0,10/24/2013,Durham University
john3vox,1,1,0,0,0,10/24/2013,Harvard ITC
veronica.arias.callejas,1,1,0,0,0,10/25/2013,SIfA
Locutus,1,1,0,0,0,10/28/2013,ASIAA
nbate,1,1,0,0,0,10/30/2013,SIfA
tcv,1,1,0,0,0,10/30/2013,Carnegie Mellon University
madsense,1,1,0,0,0,11/01/2013,McGill
eigenbrot,1,1,0,0,0,11/04/2013,UW Madison
Ching-Wa Yip,1,1,0,0,0,11/05/2013,Johns Hopkins
Danai,1,1,0,0,0,11/06/2013,University of Amsterdam
fvogt,1,1,0,0,0,11/07/2013,RSAA-ANU
lkahre,1,1,0,0,0,11/10/2013,NMSU
MarcoCastellano,1,1,0,0,0,11/13/2013,INAF-OAR
cftcorreia,1,1,0,0,0,11/14/2013,UW Madison
atchekho,1,1,0,0,0,11/19/2013,UCB
aemerick,1,1,0,0,0,11/24/2013,Columbia
djaimes,1,1,0,0,0,11/25/2013,Columbia
alexsm,1,1,0,0,0,11/28/2013,IAC
MasatoKobayashi,1,1,0,0,0,12/05/2013,Kavli IPMU
JulienNGirard,1,1,0,0,0,12/05/2013,CEA Saclay
TimN,1,1,0,0,0,12/09/2013,University of Exeter
tmccrack,1,1,0,0,0,12/13/2013,Yale-Planets
lhan,1,1,0,0,0,12/16/2013,Georgia Tech
savage,1,1,0,0,0,12/17/2013,University of Utah
briankimmig,1,1,0,0,0,12/17/2013,University of Utah
jyseok,1,1,0,0,0,12/18/2013,ASIAA
ryankeenan,1,1,0,0,0,12/23/2013,ASIAA
llondon6,1,1,0,0,0,01/08/2014,Georgia Tech
Darryl,1,1,0,0,0,01/13/2014,University of Exeter
dan.filler,1,1,0,0,0,01/14/2014,University of Utah
saldanha,1,1,0,0,0,01/15/2014,Chicago-KICP
wtgee,1,1,0,0,0,01/16/2014,University of Hawaii at Hilo
rjsmethurst,1,1,0,0,0,01/16/2014,Oxford University - Galaxies
PAC-man,1,1,0,0,0,01/16/2014,University of Oklahoma
jallen,1,1,0,0,0,01/19/2014,SIfA
Cbilinski,1,1,0,0,0,01/22/2014,Arizona
karla,1,1,0,0,0,01/22/2014,PUC-Institute of Astrophysics
yuanq,1,1,0,0,0,01/24/2014,UNLV
twong2,1,1,0,0,0,01/27/2014,UIUC
olmstead,1,1,0,0,0,01/28/2014,University of Utah
rogerdavies,1,1,0,0,0,02/01/2014,Oxford University - Galaxies
fan,1,1,0,0,0,02/02/2014,WVU
piepopyb,1,1,0,0,0,02/03/2014,INAF-OAR
liciaverde,1,1,0,1,0,02/03/2014,ICCUB
rauljimz,1,1,0,0,0,02/03/2014,ICCUB
Davide,1,1,0,0,0,02/03/2014,Kapteyn-HI
nflagey,1,1,0,0,0,02/03/2014,"IfA, University of Hawaii"
vdomcke,1,1,0,0,0,02/04/2014,SISSA
wparmentrout,1,1,0,0,0,02/05/2014,WVU
nindriolo,1,1,0,0,0,02/06/2014,Johns Hopkins
pag227,1,1,0,0,0,02/06/2014,Cornell-Cosmo
kelle,1,1,0,0,0,02/10/2014,AMNH
lucaalbrizzo,1,1,0,0,0,02/11/2014,SISSA
bahicks,1,1,0,0,0,02/11/2014,NASA Goddard Space Flight Center
rmiller,1,1,0,0,0,02/13/2014,WVU
carmen,1,1,0,0,0,02/14/2014,University of Milano-Bicocca
swiggumj,1,1,0,0,0,02/18/2014,WVU
avieregg,1,1,0,0,0,02/19/2014,Chicago-KICP
francesca_bo,1,1,0,0,0,02/19/2014,INAF-OAR
ppaykari,1,1,0,0,0,02/26/2014,CEA Saclay CosmoStat
ruxandra,1,1,0,0,0,02/28/2014,Zürich
b0burk02,1,1,0,0,0,03/04/2014,Harvard ITC
g_b,1,1,0,0,0,03/05/2014,University of Heidelberg ITP/ITA
zakamska,1,1,0,1,0,03/06/2014,Johns Hopkins
scottez,1,1,0,0,0,03/17/2014,IAP Cosmology and Extragalactic
liuguilin,1,1,0,0,0,03/19/2014,Johns Hopkins
khan.rubab,1,1,0,0,0,03/19/2014,OSU Astronomy
jajohnson51,1,1,0,0,0,03/19/2014,OSU Astronomy
daniel.reardon,1,1,0,0,0,03/24/2014,MoCA
svillan,1,1,0,0,0,03/24/2014,OSU Astronomy
Calen B. Henderson,1,1,0,0,0,03/26/2014,OSU Astronomy
janis,1,1,0,0,0,03/27/2014,"IfA, University of Hawaii"
jasoncurtis,1,1,0,0,0,03/28/2014,Penn State
Thomas Crawford,1,1,0,0,0,04/01/2014,Chicago-KICP
dmn,1,1,0,0,0,04/02/2014,Edinburgh
joe_silk,1,1,0,0,0,04/03/2014,IAP Cosmology and Extragalactic
ping,1,1,0,0,0,04/08/2014,Stanford
pfouque,1,1,0,0,0,04/09/2014,CFHT
Wei-Ting,1,1,0,0,0,04/09/2014,NTHU
hojohan,1,1,0,0,0,04/12/2014,NTHU
aman,1,1,0,0,0,04/14/2014,Clemson
JaneDai,1,1,0,0,0,04/14/2014,University of Maryland
gen,1,1,0,0,0,04/21/2014,U. Pittsburgh
sashaph,1,1,0,0,0,04/23/2014,PMO
diaz,1,1,0,0,0,04/28/2014,CEFCA
jmshi,1,1,0,0,0,05/01/2014,UCB
Bicknell,1,1,0,1,0,05/05/2014,RSAA-ANU
laurelesh,1,1,0,0,0,05/05/2014,UCSC-HEP
chelseaharris,1,1,0,0,0,05/19/2014,UCB
Geoff,1,1,0,0,0,05/19/2014,"IfA, University of Hawaii"
akamble,1,1,0,0,0,05/21/2014,Harvard ITC
ekoulour,1,1,0,0,0,05/28/2014,NOA
Zatosan,1,1,0,0,0,05/29/2014,NOA
corralra,1,1,0,0,0,06/05/2014,NOA
bruclaud,1,1,0,0,0,06/30/2014,ETH-Extragalactic
VMason,1,1,0,0,0,07/24/2014,Texas A&M
maccagni,1,1,0,0,0,08/05/2014,Kapteyn-HI
roy,1,1,0,0,0,08/06/2014,"U. de Concepcion: Planetary, Stellar, Galactic, Extragalactic papers"
abauer,1,1,0,0,0,08/07/2014,AAO
ektapatel,1,1,0,0,0,08/13/2014,Arizona
wenbinlu,1,1,0,0,0,08/25/2014,UT Austin
sbrennan,1,1,0,0,0,08/27/2014,Rutgers
rmartinez,1,1,0,0,0,08/28/2014,UT Austin
davidharvey1986,1,1,0,0,0,09/01/2014,EPFL - UniGe
dblankj,1,1,0,0,0,09/04/2014,University of Maryland
knalew,1,1,0,0,0,09/05/2014,Stanford
junhui,1,1,0,0,0,09/08/2014,Chicago-KICP
Murdock,1,1,0,0,0,09/09/2014,Johns Hopkins
tmittal2,1,1,0,0,0,09/09/2014,UCB
isagiv,1,1,0,0,0,09/10/2014,Weizmann Institute of Science
mayukh,1,1,0,0,0,09/12/2014,IUCAA
pmocz,1,1,0,0,0,09/17/2014,Harvard ITC
conroy,1,1,0,0,0,09/18/2014,Harvard ITC
bireland,1,1,0,0,0,09/18/2014,RIT-CCRG
jh6p,1,1,0,0,0,09/23/2014,Middle Tennessee State University
lwymarie,1,1,0,0,0,09/24/2014,UCSC
Kate,1,1,0,0,0,09/26/2014,MoCA
szieleniewski,1,1,0,0,0,10/02/2014,Oxford University - Galaxies
atiley,1,1,0,0,0,10/02/2014,Oxford University - Galaxies
marusa,1,1,0,0,0,10/08/2014,UCD
rjoseph,1,1,0,0,0,10/09/2014,EPFL - UniGe
Seb,1,1,0,1,0,10/09/2014,"U. of Sussex, Astronomy Centre"
sakaricm,1,1,0,0,0,10/09/2014,University of Washington
ntveem,1,1,0,0,0,10/10/2014,Caltech
nichal,1,1,0,0,0,10/10/2014,Caltech
roman.gold,1,1,0,0,0,10/10/2014,University of Maryland
johnf5007,1,1,0,0,0,10/13/2014,UT Austin
tbronzwaer,1,1,0,0,0,10/17/2014,Radboud University Nijmegen
TimDavis,1,1,0,0,0,10/17/2014,University of Hertfordshire
Stefano,1,1,0,0,0,10/17/2014,INAF - Astronomical Observatory of Capodimonte
fboulang,1,1,0,0,0,10/17/2014,IAS Orsay - ISM
ashbaker,1,1,0,0,0,10/21/2014,UPenn
Aycin Aykutalp,1,1,0,0,0,10/22/2014,Georgia Tech
nao,1,1,0,0,0,10/22/2014,Kavli IPMU
ThomasTram,1,1,0,0,0,10/22/2014,ICG Portsmouth
DeLeo,1,1,0,0,0,10/24/2014,UCR
corneliusrampf,1,1,0,0,0,10/27/2014,ICG Portsmouth
floridakeith,1,1,0,0,0,10/29/2014,ICS
ycguo,1,1,0,0,0,10/29/2014,UCSC
Lucia,1,1,0,0,0,11/03/2014,University of Amsterdam
liyp,1,1,0,0,0,11/04/2014,U. Mass
ethanlake,1,1,0,0,0,11/04/2014,University of Utah
mcalapa,1,1,0,0,1,11/06/2014,UCSC
jgribbin,1,1,0,0,0,11/06/2014,"U. of Sussex, Astronomy Centre"
debel,1,1,0,1,0,11/10/2014,AMNH
juhan,1,1,0,0,0,11/11/2014,Tartu Obs
liodakis,1,1,0,0,0,11/12/2014,University of Crete
jlippuner,1,1,0,0,0,11/18/2014,Caltech
drozdov.1,1,1,0,0,0,11/19/2014,Clemson
kazumi kashiyama,1,1,0,0,0,11/20/2014,UCB
ebaxter,1,1,0,0,0,11/21/2014,UPenn
akras,1,1,0,0,0,11/22/2014,Valongo Observatory
mpronco,1,1,0,0,0,12/02/2014,IALP-FCAGLP
fateppapannia,1,1,0,0,0,12/02/2014,IALP-FCAGLP
lulikrai,1,1,0,0,0,12/03/2014,IALP-FCAGLP
agarwalb,1,1,0,0,0,12/03/2014,Yale
santimda,1,1,0,0,0,12/04/2014,IALP-FCAGLP
hasret,1,1,0,0,0,12/09/2014,Istanbul University
nimishak,1,1,0,0,0,12/11/2014,Cambridge
Jacob,0,0,0,0,0,08/29/2009,UCSC
pk,0,0,0,0,0,08/31/2009,UCSC
astro-ph,0,0,0,0,206571,09/18/2009,unaffiliated
Heather,0,0,0,0,0,02/23/2010,UCSC
Rychard,0,0,0,0,1,03/18/2010,UCSC
Stefano,0,0,0,0,0,05/04/2010,UCSC
Nadine,0,0,0,0,4,05/07/2010,UCSC
m.morscher,0,0,0,0,0,07/05/2010,CIERA
Michael_T,0,0,0,0,0,07/06/2010,CIERA
sabine,0,0,0,0,0,07/06/2010,DARK
justin,0,0,0,0,0,07/06/2010,CIERA
scyoon,0,0,0,0,0,07/09/2010,AIfA
Bradsol,0,0,0,0,0,07/12/2010,CIERA
tianfeng,0,0,0,0,0,07/20/2010,unaffiliated
martina,0,0,0,0,0,07/27/2010,DARK
stefanbanev,0,0,0,0,0,08/03/2010,unaffiliated
kylekremer,0,0,0,0,0,08/11/2010,CIERA
strail,0,0,0,0,0,08/12/2010,UQ
Jenny Davis,0,0,0,0,0,08/12/2010,unaffiliated
tripathi,0,0,0,0,0,08/16/2010,Harvard ITC
jburns,0,0,0,0,0,08/18/2010,UQ
gduchene,0,0,0,0,0,08/25/2010,UCB
jpober,0,0,0,0,0,08/25/2010,unaffiliated
mdavis,0,0,0,0,0,08/25/2010,UCB
cmckee,0,0,0,0,0,08/26/2010,UCB
mpan,0,0,0,0,0,08/26/2010,UCB
cpma,0,0,0,0,0,09/02/2010,UCB
Genevieve Graves,0,0,0,0,0,09/07/2010,UCB
chapuflin,0,0,0,0,0,09/07/2010,UCB
liubo,0,0,0,0,0,09/08/2010,unaffiliated
thebaron,0,0,0,0,0,09/08/2010,Columbia
szhang,0,0,0,0,0,09/08/2010,Columbia
smohamed,0,0,0,0,0,09/09/2010,AIfA
jweston,0,0,0,0,0,09/09/2010,unaffiliated
Jennifer,0,0,0,0,0,09/11/2010,Columbia
Lijing Shao,0,0,0,0,0,09/15/2010,unaffiliated
yuanhb,0,0,0,0,0,09/15/2010,PKU
fangx,0,0,0,0,0,09/15/2010,PKU
Sophie-yang,0,0,0,0,0,09/15/2010,PKU
TieLiu,0,0,0,0,0,09/16/2010,PKU
wangqiao,0,0,0,0,0,09/16/2010,PKU
Xu Jun,0,0,0,0,0,09/16/2010,PKU
brandon,0,0,0,0,0,09/16/2010,Columbia
lzhu,0,0,0,0,0,09/17/2010,PKU
Chengliang Jiao,0,0,0,0,0,09/20/2010,PKU
tayyaba,0,0,0,0,0,09/20/2010,DARK
Yidong Xu,0,0,0,0,0,09/21/2010,PKU
Cristiano,0,0,0,0,0,09/21/2010,DARK
richinax,0,0,0,0,0,09/21/2010,PKU
dwkim,0,0,0,0,0,09/24/2010,HEAD-CfA
Branden,0,0,0,0,0,09/24/2010,HEAD-CfA
dpatnaude,0,0,0,0,0,09/24/2010,HEAD-CfA
cjma,0,0,0,0,0,09/27/2010,Durham University
afruscione,0,0,0,0,0,09/27/2010,HEAD-CfA
dharam,0,0,0,0,0,09/27/2010,HEAD-CfA
Paul Green,0,0,0,0,0,09/27/2010,HEAD-CfA
vince,0,0,0,0,0,09/28/2010,HEAD-CfA
mhughes,0,0,0,0,0,09/28/2010,UCB
Xiaohong Cui,0,0,0,0,0,09/29/2010,PKU
daishi,0,0,0,0,0,09/29/2010,PKU
ekellogg,0,0,0,0,0,09/29/2010,HEAD-CfA
fmassaro,0,0,0,0,0,09/30/2010,unaffiliated
mdt,0,0,0,0,0,09/30/2010,HEAD-CfA
malgosia,0,0,0,0,0,09/30/2010,HEAD-CfA
fmassaro79,0,0,0,0,0,09/30/2010,HEAD-CfA
atteniclern,0,0,0,0,0,10/04/2010,unaffiliated
Ingo Thies,0,0,0,0,0,10/05/2010,AIfA
oferc,0,0,0,0,0,10/08/2010,HEAD-CfA
vkashyap,0,0,0,0,0,10/08/2010,HEAD-CfA
mmodjaz,0,0,0,0,0,10/13/2010,Columbia
athena,0,0,0,0,0,10/21/2010,Caltech
rolando.pazjurado,0,0,0,0,0,10/22/2010,Caltech
wrf,0,0,0,0,0,10/22/2010,HEAD-CfA
goren,0,0,0,0,0,10/22/2010,HEAD-CfA
amarinucci,0,0,0,0,0,10/22/2010,HEAD-CfA
xantox86,0,0,0,0,0,10/22/2010,HEAD-CfA
lhillenbrand,0,0,0,0,0,10/25/2010,Caltech
jlynn,0,0,0,0,0,10/25/2010,UCB
Chao-Chin,0,0,0,0,1,10/27/2010,UCSC
Anthony Harness,0,0,0,0,0,11/04/2010,CU Boulder
greg,0,0,0,0,0,11/04/2010,CU Boulder
bnhan,0,0,0,3,0,11/05/2010,CU Boulder
Ben Zeiger,0,0,0,1,0,11/05/2010,CU Boulder
mwbautz,0,0,0,0,0,11/08/2010,MIT
jeroenhoman,0,0,0,0,0,11/08/2010,MIT
emirkmo,0,0,0,0,0,11/08/2010,Columbia
albrecht,0,0,0,0,0,11/09/2010,MIT
robyn,0,0,0,0,0,11/12/2010,MIT
emtilton,0,0,0,0,0,11/12/2010,CU Boulder
prbrady,0,0,0,0,0,11/15/2010,UW Milwaukee
zukin,0,0,0,0,0,11/16/2010,MIT
ram,0,0,0,0,0,11/16/2010,UW Milwaukee
orakic,0,0,0,0,0,11/17/2010,Leiden
jeno,0,0,0,0,0,11/22/2010,Columbia
kaplan,0,0,0,0,0,11/29/2010,UW Milwaukee
yuri,0,0,0,0,0,12/01/2010,Leiden
etenenbaum,0,0,0,0,0,12/02/2010,Leiden
jholt,0,0,0,0,0,12/02/2010,Leiden
Shannon Patel,0,0,0,0,0,12/02/2010,Carnegie
test,0,0,0,0,0,12/02/2010,CEA Saclay
vickyscowcroft,0,0,0,0,0,12/02/2010,Carnegie
Marc Sauvage,0,0,0,0,0,12/03/2010,CEA Saclay
vian,0,0,0,0,0,12/06/2010,CEA Saclay
rutger,0,0,0,0,0,12/08/2010,Leiden
nguyen,0,0,0,0,0,12/09/2010,unaffiliated
ortizotalvaro,0,0,0,0,0,12/09/2010,Leiden
Peter Fred,0,0,0,0,0,12/12/2010,unaffiliated
jules,0,0,0,0,0,12/16/2010,Columbia
smcgee,0,0,0,0,0,12/20/2010,unaffiliated
mtmannh,0,0,0,0,0,01/04/2011,unaffiliated
gereb,0,0,0,0,0,01/06/2011,Kapteyn
Latif,0,0,0,0,0,01/06/2011,Kapteyn
Yunhee,0,0,0,0,0,01/07/2011,Kapteyn
Oscar,0,0,0,0,0,01/07/2011,Kapteyn
buddel,0,0,0,0,0,01/09/2011,Kapteyn
podio,0,0,0,0,0,01/10/2011,Kapteyn
germancho,0,0,0,0,0,01/12/2011,Kapteyn
pierste,0,0,0,0,0,01/14/2011,unaffiliated
julienzoubian,0,0,0,0,0,01/18/2011,LAM
treyer,0,0,0,0,0,01/19/2011,LAM
s.meneses-goytia,0,0,0,0,0,01/20/2011,Kapteyn
lostorero,0,0,0,0,0,01/20/2011,HEAD-CfA
giuliamigliori,0,0,0,0,0,01/20/2011,HEAD-CfA
GijsVerdoesKleijn,0,0,0,0,0,01/26/2011,Kapteyn
jcuby,0,0,0,0,0,01/26/2011,LAM
Dae-Won Kim,0,0,0,0,0,01/28/2011,HEAD-CfA
htlee,0,0,0,0,0,01/31/2011,ASIAA
lijin,0,0,0,0,0,01/31/2011,ASIAA
despada,0,0,0,0,0,01/31/2011,unaffiliated
szomoru,0,0,0,0,0,01/31/2011,Leiden
altsai,0,0,0,0,0,01/31/2011,ASIAA
silvia.toonen,0,0,0,0,0,01/31/2011,Leiden
avila,0,0,0,0,0,02/01/2011,STScI/JHU
jmirocha05,0,0,0,0,0,02/01/2011,CU Boulder
jonpreston,0,0,0,0,0,02/01/2011,STScI/JHU
drsoderblom,0,0,0,0,0,02/01/2011,STScI/JHU
bianca,0,0,0,0,0,02/02/2011,LAM
vegan,0,0,0,0,0,02/02/2011,unaffiliated
Diana Juncher,0,0,0,0,0,02/06/2011,DARK
kiwizhang,0,0,0,0,0,02/08/2011,unaffiliated
ChrisMessenger,0,0,0,0,0,02/08/2011,UW Milwaukee
ads92,0,0,0,0,0,02/10/2011,U. Pittsburgh
Ji-hoon Kim,0,0,0,0,1,02/11/2011,Caltech
bbertinc,0,0,0,0,0,02/11/2011,Columbia
TsingWai,0,0,0,0,0,02/14/2011,CIERA
sami,0,0,0,0,0,02/15/2011,STScI/JHU
vkilborn,0,0,0,0,0,02/18/2011,Swinburne
gdiaz,0,0,0,0,0,02/18/2011,Swinburne
windemuth,0,0,0,0,0,02/18/2011,Columbia
skvikas,0,0,0,0,0,02/21/2011,U. Pittsburgh
stratocat,0,0,0,0,0,02/23/2011,unaffiliated
liuchao,0,0,0,0,0,02/24/2011,unaffiliated
cfluke,0,0,0,0,0,02/24/2011,Swinburne
Bililign,0,0,0,0,0,02/25/2011,Swinburne
mjauzac,0,0,0,0,0,02/28/2011,LAM
stephanfrank,0,0,0,0,0,02/28/2011,LAM
josh,0,0,0,0,0,03/01/2011,UCB
rasio,0,0,0,0,0,03/07/2011,CIERA
jeg,0,0,0,0,0,03/08/2011,LAM
cfoster,0,0,0,0,0,03/11/2011,Swinburne
hkuntsch,0,0,0,0,0,03/11/2011,ESO Garching
uayeb,0,0,0,0,0,03/24/2011,Swinburne
lrobinson,0,0,0,0,0,03/25/2011,UQ
SamNolan,0,0,0,0,0,03/26/2011,UQ
rodleiva,0,0,0,0,0,03/26/2011,PUC-Institute of Astrophysics
maren551,0,0,0,0,0,03/30/2011,PUC-Institute of Astrophysics
mpetr,0,0,0,0,0,04/05/2011,ESO Garching
sbasa,0,0,0,0,0,04/06/2011,LAM
tp,0,0,0,0,0,04/06/2011,Caltech
hiroya,0,0,0,0,0,04/08/2011,HEAD-CfA
daalen,0,0,0,0,0,04/12/2011,UCB
Cinthya Herrera,0,0,0,0,0,04/12/2011,IAS Orsay - ISM
caiz,0,0,0,0,0,04/16/2011,Arizona
ksu,0,0,0,0,0,04/18/2011,Arizona
gwalth,0,0,0,0,0,04/19/2011,Arizona
mirko_sm,0,0,0,0,0,04/19/2011,PUC-Institute of Astrophysics
romeeld,0,0,0,0,0,04/19/2011,Arizona
mcatelan,0,0,0,0,0,04/20/2011,PUC-Institute of Astrophysics
fbocchino,0,0,0,0,0,04/23/2011,unaffiliated
Nicolastro,0,0,0,0,0,04/24/2011,unaffiliated
glagache,0,0,0,0,0,04/26/2011,IAS Orsay
chrisjones,0,0,0,0,0,04/26/2011,IAS Orsay
ccaceres,0,0,0,0,0,04/26/2011,PUC-Institute of Astrophysics
cinfante,0,0,0,0,0,04/27/2011,PUC-Institute of Astrophysics
Duilia de Mello,0,0,0,0,0,04/27/2011,PUC-Institute of Astrophysics
paguirre,0,0,0,0,0,04/27/2011,PUC-Institute of Astrophysics
nebu83,0,0,0,0,0,04/28/2011,unaffiliated
mwilson,0,0,0,0,0,04/29/2011,Arizona
denis.burgarella@oamp.fr,0,0,0,0,0,05/04/2011,LAM
Kristoffer Stensbo-Smidt,0,0,0,0,0,05/05/2011,DARK
socrates,0,0,0,0,0,05/15/2011,unaffiliated
jinyoungserena,0,0,0,0,0,05/19/2011,Arizona
chris.dandrea,0,0,0,0,0,05/25/2011,UPenn
fnoviell,0,0,0,0,0,05/26/2011,IAS Orsay
elnjensen,0,0,0,0,0,05/26/2011,UPenn
cabre,0,0,0,0,0,05/26/2011,UPenn
bjain,0,0,0,0,0,05/26/2011,unaffiliated
eddevinney,0,0,0,0,0,05/27/2011,unaffiliated
cztsy,0,0,0,0,0,05/31/2011,Caltech
sfinn,0,0,0,0,0,06/09/2011,Boston University
skartha,0,0,0,0,0,06/10/2011,Swinburne
LAPorter,0,0,0,0,0,06/10/2011,UCSC
apinnick,0,0,0,0,0,06/10/2011,Boston University
mzastrow,0,0,0,0,0,06/12/2011,Boston University
nick,0,0,0,0,0,06/13/2011,Boston University
mmalmrose,0,0,0,0,0,06/16/2011,Boston University
psteger,0,0,0,0,0,06/22/2011,ETH-Extragalactic
anonymous,0,0,0,0,0,06/23/2011,unaffiliated
Kenneth Janes,0,0,0,0,0,06/23/2011,Boston University
Simon Lilly,0,0,0,0,0,06/27/2011,ETH-Extragalactic
bconnolly2002,0,0,0,0,0,06/29/2011,UPenn
mark_ammons81,0,0,0,0,0,07/13/2011,Arizona
Joy Painter,0,0,0,0,0,07/13/2011,Caltech
aamara,0,0,0,0,0,07/15/2011,ETH-Extragalactic
rdecker,0,0,0,0,0,07/15/2011,UCR
B.Scott,0,0,0,0,0,07/15/2011,UCR
mrabus,0,0,0,0,0,07/25/2011,PUC-Institute of Astrophysics
bemcarthur,0,0,0,0,0,07/25/2011,UT Austin
gfritz,0,0,0,0,0,07/25/2011,UT Austin
wheel,0,0,0,0,0,07/25/2011,UT Austin
Santana9937,0,0,0,0,0,07/25/2011,UT Austin
jscalo,0,0,0,0,0,07/26/2011,UT Austin
dll,0,0,0,0,0,07/27/2011,UofT
sujitkumarnath,0,0,0,1,0,08/01/2011,IISc-RRI
nnvutisa,0,0,0,0,0,08/01/2011,UT Austin
vinu,0,0,0,0,0,08/05/2011,UPenn
koutarou,0,0,0,0,0,08/08/2011,UW Milwaukee
Steven,0,0,0,0,0,08/10/2011,Columbia
kliebst,0,0,0,0,0,08/10/2011,ASU Astro
tveach,0,0,0,0,0,08/12/2011,ASU Astro
Loic,0,0,0,0,0,08/16/2011,unaffiliated
Lisa_Rosen,0,0,0,0,0,08/18/2011,Uppsala
wdc,0,0,0,0,0,08/19/2011,UT Austin
siyu.zhou,0,0,0,0,0,08/19/2011,UCR
nrbutler,0,0,0,0,0,08/19/2011,ASU Astro
idekany,0,0,0,0,0,08/19/2011,PUC-Institute of Astrophysics
harvey98,0,0,0,0,0,08/19/2011,ASU Astro
songhuang_nju,0,0,0,0,0,08/20/2011,unaffiliated
garethmurphy,0,0,0,0,0,08/20/2011,unaffiliated
tmozdzen,0,0,0,0,0,08/20/2011,ASU Astro
HughesMaureen,0,0,0,0,0,08/22/2011,unaffiliated
chw3k5,0,0,0,0,0,08/22/2011,ASU Astro
RogierWindhorst,0,0,0,0,0,08/22/2011,ASU Astro
nilaybhatt,0,0,0,0,0,08/23/2011,unaffiliated
ascaife,0,0,0,0,0,08/23/2011,DIAS
syliu,0,0,0,0,0,08/24/2011,ASIAA
Malcolm Walmsley,0,0,0,0,0,08/24/2011,unaffiliated
novaric,0,0,0,0,0,08/25/2011,CRAL
rainsworth,0,0,0,0,0,08/26/2011,DIAS
edenastro,0,0,0,0,0,08/27/2011,unaffiliated
miecka,0,0,0,0,0,08/29/2011,Leiden
marinoni,0,0,0,0,0,08/30/2011,LAM
koen_maaskant,0,0,0,0,0,08/30/2011,GRAPPA Institute
kasen,0,0,0,0,0,09/01/2011,UCB
granttremblay,0,0,0,0,0,09/07/2011,ESO Garching
mark.vogelsberger,0,0,0,0,0,09/08/2011,unaffiliated
pecontal,0,0,0,0,0,09/08/2011,CRAL
ssalaza1,0,0,0,0,0,09/11/2011,PUC-Institute of Astrophysics
bsmith18,0,0,0,0,0,09/12/2011,ASU Astro
Cjvargas90,0,0,0,0,0,09/12/2011,Rutgers
jmmichea,0,0,0,0,0,09/13/2011,PUC-Institute of Astrophysics
ebowsher,0,0,0,0,0,09/14/2011,Columbia
Donghui Jeong,0,0,0,0,0,09/14/2011,STScI/JHU
Cepebonssog,0,0,0,0,0,09/15/2011,unaffiliated
rearmstr,0,0,0,0,0,09/15/2011,UPenn
rsomerville,0,0,0,0,0,09/15/2011,Rutgers
kerstin,0,0,0,0,0,09/16/2011,Stony Brook
katemari,0,0,0,0,0,09/17/2011,Columbia
zhengyu,0,0,0,0,0,09/19/2011,KIAA-Clusters
wenting,0,0,0,0,0,09/20/2011,MPA Garching
rfisher,0,0,0,0,0,09/20/2011,U. Mass
Kijeong,0,0,0,0,0,09/20/2011,UIUC-SF
ccarveth,0,0,0,0,0,09/20/2011,Boston University
ivince,0,0,0,0,0,09/21/2011,AOB
freddy cueva solano,0,0,0,0,0,09/21/2011,unaffiliated
jesien56,0,0,0,0,0,09/22/2011,unaffiliated
francesca,0,0,0,0,0,09/22/2011,LAM
roland,0,0,0,0,0,09/22/2011,CRAL
naudus,0,0,0,0,0,09/22/2011,Rutgers
oliveira,0,0,0,0,0,09/22/2011,UT Austin
ted.williams,0,0,0,0,0,09/23/2011,Rutgers
Zack Dugan,0,0,0,0,0,09/23/2011,unaffiliated
elovegrove,0,0,0,0,4,09/26/2011,UCSC
Vitaly,0,0,0,0,0,09/26/2011,Uppsala
lsturch,0,0,0,0,0,09/26/2011,Boston University
jberge,0,0,0,0,0,09/26/2011,ETH-Extragalactic
fulviomelia,0,0,0,0,0,09/27/2011,Arizona
ycao,0,0,0,0,0,09/29/2011,Caltech
Sreeja,0,0,0,0,0,09/30/2011,Swinburne
Guido,0,0,0,0,0,09/30/2011,Swinburne
bnovakovic,0,0,0,0,0,09/30/2011,AOB
tanmay,0,0,0,0,0,10/03/2011,ASU Astro
Romain,0,0,0,0,0,10/04/2011,LAM
kevin861,0,0,0,0,0,10/05/2011,unaffiliated
bradley,0,0,0,0,0,10/05/2011,STScI/JHU
ebuenzli,0,0,0,0,0,10/05/2011,MPIA
srdjan,0,0,0,0,0,10/06/2011,AOB
mohakash,0,0,0,0,0,10/06/2011,Swinburne
maria,0,0,0,0,0,10/06/2011,Columbia
miao,0,0,0,0,0,10/07/2011,Columbia
raman,0,0,0,0,0,10/07/2011,UW Milwaukee
yyang,0,0,0,0,0,10/10/2011,unaffiliated
testuser,0,0,0,0,0,10/11/2011,CEA Saclay
okumura,0,0,0,0,0,10/11/2011,CEA Saclay
Summer,0,0,0,0,0,10/12/2011,Columbia
henrique,0,0,0,0,0,10/13/2011,Valongo Observatory
iferrero,0,0,0,0,0,10/17/2011,MPA Garching
aurban,0,0,0,0,0,10/17/2011,UW Milwaukee
florian,0,0,0,0,0,10/18/2011,ICRAR
Mathieu R,0,0,0,0,0,10/18/2011,IAS Orsay
Diego,0,0,0,0,0,10/18/2011,unaffiliated
b_ramos,0,0,0,0,0,10/18/2011,unaffiliated
Kevin,0,0,0,0,0,10/19/2011,ICRAR
PeterQ,0,0,0,0,0,10/19/2011,ICRAR
MitziHeath,0,0,0,0,0,10/19/2011,unaffiliated
jurek.m.malarecki,0,0,0,0,0,10/20/2011,ICRAR
msoares,0,0,0,0,0,10/20/2011,UCSC
dg,0,0,0,0,0,10/21/2011,ICRAR
obreschkow,0,0,0,0,0,10/21/2011,ICRAR
biqing,0,0,0,0,0,10/21/2011,ICRAR
photonomer,0,0,0,0,0,10/21/2011,ICRAR
thaismothe,0,0,0,0,0,10/21/2011,Valongo Observatory
uiolioupio,0,0,0,0,0,10/25/2011,unaffiliated
dahlen,0,0,0,0,0,10/26/2011,STScI/JHU
meiyu,0,0,0,0,0,10/27/2011,U. Pittsburgh
olivia,0,0,0,0,0,11/02/2011,AOB
spt,0,0,0,0,0,11/02/2011,Caltech
seviagraua,0,0,0,0,0,11/05/2011,unaffiliated
dey,0,0,0,0,0,11/05/2011,Arizona
psheehan,0,0,0,0,0,11/05/2011,Arizona
srikar,0,0,0,0,4,11/07/2011,UCSC
ChristianRab,0,0,0,0,0,11/07/2011,University of Vienna
kjorgenson,0,0,0,0,0,11/08/2011,University of Florida
matias.montesinos,0,0,0,0,0,11/09/2011,PUC-Institute of Astrophysics
malone,0,0,0,0,4,11/09/2011,UCSC
mingli,0,0,0,0,0,11/10/2011,MPA Garching
ewhelan,0,0,0,0,0,11/10/2011,DIAS
Andrej,0,0,0,0,0,11/10/2011,AOB
zcvetkovic,0,0,0,0,0,11/11/2011,AOB
ahenry,0,0,0,0,0,11/11/2011,unaffiliated
hanym,0,0,0,0,0,11/14/2011,AIfA
hananeh,0,0,0,0,0,11/15/2011,AIfA
cmolina,0,0,0,0,0,11/16/2011,Valongo Observatory
dzaritsky,0,0,0,0,0,11/16/2011,Arizona
F. J. Amaral Vieira,0,0,0,0,0,11/18/2011,unaffiliated
emily,0,0,0,0,0,11/18/2011,Texas A&M
lauer,0,0,0,0,0,11/18/2011,unaffiliated
goran,0,0,0,0,0,11/22/2011,AOB
lucia.morganti,0,0,0,0,0,11/23/2011,MPA Garching
fjdu,0,0,0,0,0,11/23/2011,unaffiliated
postman,0,0,0,0,0,11/23/2011,STScI/JHU
ananda,0,0,0,0,0,11/24/2011,unaffiliated
neilzim,0,0,0,0,0,11/25/2011,unaffiliated
Manash Samal,0,0,0,0,0,11/27/2011,LAM
sabyasachi2,0,0,0,0,0,11/27/2011,ICRAR
jgabor,0,0,0,0,0,11/28/2011,CEA Saclay
Bitten,0,0,0,0,0,11/28/2011,DARK
franse,0,0,0,0,0,11/28/2011,Leiden-NOLG
buddendiek,0,0,0,0,0,11/28/2011,Leiden-NOLG
henk,0,0,0,0,0,11/30/2011,Leiden-NOLG
kuijken,0,0,0,0,0,11/30/2011,unaffiliated
gcaminha,0,0,0,0,0,11/30/2011,LAM
koenkuijken,0,0,0,0,0,11/30/2011,Leiden-NOLG
Thiago Monfredini,0,0,0,0,0,12/01/2011,Valongo Observatory
sprice,0,0,0,0,0,12/06/2011,UCB
dolan,0,0,0,0,0,12/06/2011,unaffiliated
natasatodo,0,0,0,0,0,12/09/2011,AOB
ivanamilic,0,0,0,0,0,12/09/2011,AOB
unclellama,0,0,0,0,0,12/12/2011,DARK
MoH,0,0,0,0,0,12/12/2011,unaffiliated
soner,0,0,0,0,0,12/13/2011,unaffiliated
dumm,0,0,0,0,0,12/13/2011,UMN
siegfried,0,0,0,0,0,12/20/2011,University of Vienna
HortonTIFFANY32,0,0,0,0,0,12/22/2011,unaffiliated
GuzmanDolores29,0,0,0,0,0,12/22/2011,unaffiliated
Graishipads,0,0,0,0,0,12/30/2011,unaffiliated
jorgelopez,0,0,0,0,0,01/01/2012,unaffiliated
SuzetteAlston18,0,0,0,0,0,01/04/2012,unaffiliated
vorobie2,0,0,0,0,0,01/10/2012,University of Vienna
Georges Meylan,0,0,0,0,0,01/12/2012,EPFL - UniGe
mkao,0,0,0,0,0,01/13/2012,Caltech
aroffringa,0,0,0,0,0,01/13/2012,unaffiliated
dnamurphy,0,0,0,0,0,01/15/2012,PUC-Institute of Astrophysics
ZXJ,0,0,0,0,0,01/16/2012,unaffiliated
anahi,0,0,0,0,0,01/16/2012,EPFL - UniGe
paduc,0,0,0,0,0,01/16/2012,CEA Saclay
nicholashand,0,0,0,0,0,01/16/2012,UCB
mydverey,0,0,0,0,0,01/17/2012,unaffiliated
cantale,0,0,0,0,0,01/17/2012,EPFL - UniGe
MORGANGaines26,0,0,0,0,0,01/18/2012,unaffiliated
lrm,0,0,0,0,0,01/18/2012,unaffiliated
greghallinan,0,0,0,0,0,01/18/2012,Caltech
aptak,0,0,0,0,0,01/18/2012,STScI/JHU
Xing-Jiang Zhu,0,0,0,0,0,01/19/2012,ICRAR
jkovacevic,0,0,0,0,0,01/20/2012,AOB
QinghuaTAN,0,0,0,0,0,01/23/2012,CEA Saclay
ainil,0,0,0,0,0,01/24/2012,Leiden
menard,0,0,0,0,0,01/25/2012,STScI/JHU
KimkasJK,0,0,0,0,0,01/26/2012,unaffiliated
slmic,0,0,0,0,0,01/26/2012,Boston University
ellie4physics,0,0,0,0,0,01/27/2012,Yale
Pallas,0,0,0,0,0,01/30/2012,AIfA-Cosmo
MortenMedici,0,0,0,0,0,01/30/2012,DARK
ebonning,0,0,0,0,0,01/30/2012,Yale
duncan.c,0,0,0,0,0,02/01/2012,Yale
gborisov,0,0,0,0,0,02/02/2012,unaffiliated
Cosmo,0,0,0,0,0,02/02/2012,unaffiliated
Precco,0,0,0,0,0,02/02/2012,unaffiliated
jhummel,0,0,0,0,0,02/03/2012,UT Austin
JGovea,0,0,0,0,0,02/03/2012,UT Austin
jesien50,0,0,0,0,0,02/04/2012,unaffiliated
leradresse,0,0,0,0,0,02/06/2012,unaffiliated
vijay Singh,0,0,0,0,0,02/08/2012,UW Milwaukee
koalakoalizzati,0,0,0,0,0,02/09/2012,unaffiliated
greensander,0,0,0,0,0,02/09/2012,unaffiliated
wmdepous,0,0,0,0,0,02/10/2012,Leiden
ndcamtr,0,0,0,0,0,02/11/2012,unaffiliated
dgotz,0,0,0,0,0,02/13/2012,CEA Saclay High Energy
bobi,0,0,0,0,0,02/13/2012,CEA Saclay High Energy
dimplemac,0,0,0,0,0,02/13/2012,UW Milwaukee
e_abouali,0,0,0,0,0,02/14/2012,UW Milwaukee
fjackson,0,0,0,0,0,02/14/2012,HEAD-CfA
cfpl2,0,0,0,0,0,02/14/2012,MPA Garching
ochsendorf,0,0,0,0,0,02/15/2012,Leiden
nick.konidaris,0,0,0,0,0,02/15/2012,Caltech
apavan,0,0,0,0,0,02/16/2012,unaffiliated
pavana,0,0,0,0,0,02/16/2012,unaffiliated
dvince,0,0,0,0,0,02/16/2012,Geneva Cosmology Group
Maud,0,0,0,0,0,02/16/2012,Geneva Cosmology Group
ricardoheras,0,0,0,0,0,02/17/2012,unaffiliated
Ermis Mitsou,0,0,0,0,0,02/17/2012,Geneva Cosmology Group
mkunz,0,0,0,0,0,02/17/2012,Geneva Cosmology Group
daverio,0,0,0,0,0,02/17/2012,Geneva Cosmology Group
hideki,0,0,0,0,0,02/19/2012,Geneva Cosmology Group
miki obradovic,0,0,0,0,0,02/20/2012,Geneva Cosmology Group
bochanski,0,0,0,0,0,02/20/2012,unaffiliated
marc,0,0,0,0,0,02/21/2012,Geneva Cosmology Group
hope4now,0,0,0,0,0,02/22/2012,unaffiliated
astroboylrx,0,0,0,0,0,02/23/2012,KIAA-Clusters
seheon.oh,0,0,0,0,0,02/24/2012,ICRAR
egrsio,0,0,0,0,0,02/26/2012,unaffiliated
qihongcat,0,0,0,0,0,02/28/2012,UW Milwaukee
pnepal,0,0,0,0,0,02/28/2012,UW Milwaukee
eurorne,0,0,0,0,0,02/29/2012,unaffiliated
fliedia,0,0,0,0,0,02/29/2012,unaffiliated
Elisabet,0,0,0,0,0,03/01/2012,DARK
ssoldi,0,0,0,0,0,03/01/2012,CEA Saclay High Energy
Xarthisius,0,0,0,0,0,03/01/2012,unaffiliated
tweekzilla,0,0,0,0,0,03/01/2012,Columbia
elcoro54,0,0,0,0,0,03/03/2012,unaffiliated
fargion,0,0,0,0,0,03/06/2012,unaffiliated
Bertil,0,0,0,0,0,03/07/2012,unaffiliated
Geraint,0,0,0,0,0,03/08/2012,unaffiliated
diki,0,0,0,0,0,03/08/2012,unaffiliated
Marcus,0,0,0,0,0,03/09/2012,unaffiliated
chenxianpku,0,0,0,0,0,03/09/2012,PKU
kinsemc,0,0,0,0,0,03/09/2012,Georgia Tech
cmurry10,0,0,0,0,0,03/12/2012,Yale
MBiagetti,0,0,0,0,0,03/12/2012,Geneva Cosmology Group
mverduol,0,0,0,0,0,03/14/2012,University of Vienna
smriti,0,0,0,0,0,03/16/2012,UQ
tcollett,0,0,0,0,0,03/16/2012,unaffiliated
pbrown,0,0,0,0,0,03/19/2012,unaffiliated
rainer,0,0,0,0,2,03/19/2012,UCSC
Stockmann,0,0,0,0,0,03/20/2012,DARK
sarahheisler,0,0,0,0,0,03/20/2012,unaffiliated
bally,0,0,0,0,0,03/21/2012,CU Boulder
altairjunior,0,0,0,0,0,03/22/2012,Valongo Observatory
grhee,0,0,0,0,0,03/22/2012,UNLV
jarmour3,0,0,0,0,0,03/23/2012,Georgia Tech
donascimento,0,0,0,0,0,03/27/2012,unaffiliated
Joe,0,0,0,0,0,03/27/2012,UW Milwaukee
giovanni.lamura,0,0,0,0,0,03/28/2012,unaffiliated
longdon,0,0,0,0,0,03/29/2012,EPFL - UniGe
prc,0,0,0,0,0,03/30/2012,Yale
naoki.yasuda,0,0,0,0,0,03/30/2012,Kavli IPMU
tom.saito,0,0,0,0,0,03/30/2012,Kavli IPMU
miyatake,0,0,0,0,0,03/30/2012,Kavli IPMU
kmaeda,0,0,0,0,0,03/30/2012,Kavli IPMU
nobu,0,0,0,0,0,03/30/2012,Kavli IPMU
mvputten,0,0,0,0,0,03/31/2012,MIT
shimono,0,0,0,0,0,03/31/2012,Kavli IPMU
dhlesser,0,0,0,0,0,04/02/2012,Arizona
Takaya Nozawa,0,0,0,0,0,04/03/2012,Kavli IPMU
ernazar,0,0,0,0,0,04/04/2012,Caltech
abouzar,0,0,0,0,0,04/07/2012,AIfA
tbrill,0,0,0,0,0,04/10/2012,UNLV
spto,0,0,0,0,0,04/10/2012,PKU
sinemsm,0,0,0,0,0,04/10/2012,Sabanci University
ehrenfest,0,0,0,0,0,04/11/2012,unaffiliated
jballet,0,0,0,0,0,04/11/2012,CEA Saclay High Energy
xiaodongleo,0,0,0,0,0,04/12/2012,unaffiliated
xiaodongleo1,0,0,0,0,0,04/12/2012,unaffiliated
polako,0,0,0,0,0,04/12/2012,IATE
ernestozur,0,0,0,0,0,04/13/2012,IATE
dante.paz,0,0,0,0,0,04/13/2012,IATE
yang,0,0,0,0,0,04/16/2012,DoA PKU
jomeara,0,0,0,0,0,04/16/2012,unaffiliated
lferreir,0,0,0,0,0,04/17/2012,ESO Garching
xusiyao,0,0,0,0,0,04/17/2012,PKU
shiyin,0,0,0,0,0,04/18/2012,unaffiliated
emptymalei,0,0,0,0,0,04/19/2012,unaffiliated
alicsonkatich,0,0,0,0,0,04/19/2012,unaffiliated
prasundutta151,0,0,0,0,0,04/19/2012,NCRA
samrc,0,0,0,0,0,04/19/2012,NCRA
Breezy,0,0,0,0,0,04/19/2012,NCRA
Vishal Gajjar,0,0,0,0,0,04/19/2012,NCRA
naren,0,0,0,0,0,04/20/2012,NCRA
mrkite,0,0,0,0,0,04/20/2012,unaffiliated
chengalur,0,0,0,0,0,04/22/2012,unaffiliated
benopp,0,0,0,0,0,04/24/2012,CU Boulder
nityah,0,0,0,0,0,04/24/2012,MPA Garching
sfabbro,0,0,0,0,0,04/26/2012,unaffiliated
pupi,0,0,0,0,0,04/26/2012,IATE
nbaaaaaaa31,0,0,0,0,0,04/26/2012,unaffiliated
ramos,0,0,0,0,0,04/26/2012,Valongo Observatory
jingluan,0,0,0,0,0,04/28/2012,Caltech
mbusquet,0,0,0,0,0,04/30/2012,unaffiliated
bwgref,0,0,0,0,0,04/30/2012,Caltech
jaehbae,0,0,0,0,0,05/04/2012,unaffiliated
amorisconc,0,0,0,0,0,05/05/2012,unaffiliated
elenarasia,0,0,0,0,0,05/06/2012,unaffiliated
mykola,0,0,0,0,0,05/08/2012,unaffiliated
dhs,0,0,0,0,0,05/10/2012,MIT
Santucho,0,0,0,0,0,05/11/2012,IATE
oakley,0,0,0,0,0,05/14/2012,MIT
broek,0,0,0,0,0,05/14/2012,Leiden
behnaz,0,0,0,0,0,05/16/2012,UMN
maols,0,0,0,0,0,05/17/2012,unaffiliated
Vir Cuneo,0,0,0,0,0,05/22/2012,IATE
tinker,0,0,0,0,0,05/23/2012,unaffiliated
mirabal,0,0,0,0,0,05/23/2012,unaffiliated
clmw,0,0,0,0,0,05/23/2012,MIT
drastro,0,0,0,0,0,05/24/2012,Caltech
charee.peters,0,0,0,0,0,05/24/2012,MIT
kfrench,0,0,0,0,0,05/25/2012,Arizona
adama,0,0,0,0,0,05/29/2012,MIT
george,0,0,0,0,0,05/30/2012,Zürich
res@physik.uzh.ch,0,0,0,0,0,05/30/2012,Zürich
hshennan,0,0,0,0,0,05/31/2012,CU Boulder
lubini,0,0,0,0,0,06/01/2012,Zürich
Mette,0,0,0,0,0,06/01/2012,DARK
romanchero,0,0,0,0,0,06/01/2012,IATE
Lupe,0,0,0,0,0,06/01/2012,IATE
Andreas Tepe,0,0,0,0,0,06/01/2012,Georgia Tech
rathul nath,0,0,0,0,0,06/01/2012,IISc-RRI
paoloserr,0,0,0,0,0,06/04/2012,IAS Orsay
jagdish,0,0,0,0,0,06/05/2012,IISc-RRI
nazma,0,0,0,0,0,06/05/2012,IISc-RRI
kshitij,0,0,0,0,0,06/05/2012,IISc-RRI
orifox,0,0,0,0,0,06/05/2012,UCB
Sourabh,0,0,0,0,0,06/06/2012,IISc-RRI
Jonathan Freundlich,0,0,0,0,0,06/06/2012,unaffiliated
Arpita,0,0,0,0,0,06/06/2012,IISc-RRI
ehicks,0,0,0,0,0,06/06/2012,CIERA
bepinat,0,0,0,0,0,06/07/2012,LAM
picogna,0,0,0,0,0,06/07/2012,unaffiliated
RoiSantos,0,0,0,0,0,06/12/2012,University of Vienna
Maria Pena-Guerrero,0,0,0,0,0,06/12/2012,STScI/JHU
Valdis,0,0,0,0,0,06/13/2012,unaffiliated
kanhaiya,0,0,0,0,0,06/15/2012,IISc-RRI
lea,0,0,0,0,0,06/15/2012,Zürich
MHGT,0,0,0,0,0,06/17/2012,unaffiliated
thegrandvizier,0,0,0,0,0,06/21/2012,unaffiliated
pinotti,0,0,0,0,0,06/25/2012,Valongo Observatory
dodelson,0,0,0,0,0,06/27/2012,unaffiliated
ouchi,0,0,0,0,0,06/29/2012,Kavli IPMU
Andypowell,0,0,0,0,0,07/12/2012,unaffiliated
Feige Wang,0,0,0,0,0,07/13/2012,DoA PKU
yfjin,0,0,0,0,0,07/13/2012,DoA PKU
leeyp,0,0,0,0,0,07/13/2012,DoA PKU
knobelc,0,0,0,0,0,07/13/2012,ETH-Extragalactic
tmmmysteJ,0,0,0,0,0,07/14/2012,unaffiliated
tmmmysteJ,0,0,0,0,0,07/14/2012,unaffiliated
wuxb,0,0,0,0,0,07/14/2012,DoA PKU
kevinsteveBF,0,0,0,0,0,07/14/2012,unaffiliated
yangjy,0,0,0,0,0,07/16/2012,DoA PKU
Yangqian,0,0,0,0,0,07/17/2012,DoA PKU
catheyxrangel3,0,0,0,0,0,07/17/2012,unaffiliated
epico,0,0,0,0,0,07/17/2012,unaffiliated
Louise,0,0,0,0,0,07/18/2012,Yale
the_fermilab,0,0,0,0,0,07/19/2012,Harvard ITC
YQY,0,0,0,0,0,07/19/2012,DoA PKU
wcramer,0,0,0,0,0,07/19/2012,UMN
llrw,0,0,0,0,0,07/19/2012,UMN
alex.codoreanu,0,0,0,0,0,07/19/2012,UMN
farnsworth,0,0,0,0,0,07/19/2012,UMN
kmcquinn,0,0,0,0,0,07/20/2012,UMN
nhether,0,0,0,0,0,07/23/2012,UofT
Yang QY,0,0,0,0,0,07/24/2012,unaffiliated
verhoeff,0,0,0,0,0,07/25/2012,unaffiliated
ivano,0,0,0,0,0,07/27/2012,UMN
rclark7083,0,0,0,0,0,07/29/2012,unaffiliated
joergdietrich,0,0,0,0,0,07/30/2012,ETH-Extragalactic
a test user,0,0,0,0,0,08/04/2012,Harvard ITC
zengli,0,0,0,0,0,08/07/2012,Harvard ITC
kkarkare,0,0,0,0,0,08/07/2012,unaffiliated
krosenf,0,0,0,0,0,08/08/2012,Harvard ITC
tanmoy,0,0,0,0,0,08/08/2012,Harvard ITC
laha,0,0,0,0,0,08/09/2012,unaffiliated
akshatgumbhir,0,0,0,0,0,08/09/2012,UCSC
rizwan,0,0,0,0,0,08/10/2012,IUCAA
ernewton,0,0,0,0,0,08/13/2012,Harvard ITC
apiso,0,0,0,0,0,08/13/2012,Harvard ITC
llanz,0,0,0,0,0,08/13/2012,Harvard ITC
mcartale,0,0,0,0,0,08/13/2012,unaffiliated
s_rugheimer,0,0,0,0,0,08/13/2012,Harvard ITC
arlin,0,0,0,0,0,08/14/2012,Columbia
hopechen,0,0,0,0,0,08/15/2012,Harvard ITC
sheagk,0,0,0,0,0,08/15/2012,unaffiliated
joyce,0,0,0,0,0,08/15/2012,Cornell
Durgesh Tripathi,0,0,0,0,0,08/16/2012,IUCAA
Vikram,0,0,0,0,0,08/16/2012,IUCAA
souradeep,0,0,0,0,0,08/17/2012,IUCAA
aethel,0,0,0,0,0,08/18/2012,unaffiliated
Patrick Powers,0,0,0,0,0,08/19/2012,unaffiliated
drthip,0,0,0,0,0,08/20/2012,University of Florida
mshaw,0,0,0,0,0,08/21/2012,Stanford
adler_test,0,0,0,0,0,08/21/2012,unaffiliated
brackham,0,0,0,0,0,08/21/2012,Arizona
zberta,0,0,0,0,0,08/22/2012,Harvard ITC
nthomas819,0,0,0,0,0,08/22/2012,University of Florida
cfhelp,0,0,0,0,0,08/23/2012,Harvard ITC
tanya_urrutia,0,0,0,0,0,08/24/2012,unaffiliated
pak,0,0,0,0,0,08/24/2012,IUCAA
ggyuk,0,0,0,0,0,08/24/2012,Adler Planetarium
versaceglass,0,0,0,0,0,08/25/2012,ESO Garching
silverio,0,0,0,0,0,08/28/2012,UCB
pared67,0,0,0,0,0,08/28/2012,unaffiliated
lhirsch,0,0,0,0,0,08/28/2012,UCB
stahler,0,0,0,0,0,08/28/2012,UCB
Hammergren,0,0,0,0,0,08/28/2012,Adler Planetarium
KWalczak,0,0,0,0,0,08/28/2012,Adler Planetarium
smeschia,0,0,0,0,0,08/30/2012,UT Austin
suvodip,0,0,0,0,0,08/31/2012,unaffiliated
karvidsson,0,0,0,0,0,08/31/2012,Adler Planetarium
chicago314,0,0,0,0,0,08/31/2012,unaffiliated
LaurieAG,0,0,0,0,0,09/01/2012,unaffiliated
ferrarii,0,0,0,0,0,09/01/2012,ICRAR
Terzian,0,0,0,0,0,09/04/2012,Cornell
joshualande,0,0,0,0,0,09/04/2012,Stanford
rcool,0,0,0,0,0,09/04/2012,Arizona
drschmidt,0,0,0,0,0,09/04/2012,Arizona
JZamorano,0,0,0,0,0,09/05/2012,UCM
fbecerra,0,0,0,0,0,09/05/2012,Harvard ITC
mdunham,0,0,0,0,0,09/05/2012,Yale
martindelosrios,0,0,0,0,0,09/05/2012,IATE
kalexand,0,0,0,0,0,09/06/2012,Harvard ITC
bruno.s,0,0,0,0,0,09/06/2012,IATE
srividya,0,0,0,0,0,09/07/2012,IUCAA
anthea.king,0,0,0,0,0,09/07/2012,DARK
reil,0,0,0,0,0,09/07/2012,Stanford
mattr,0,0,0,0,0,09/09/2012,Vanderbilt
charlesmelby,0,0,0,0,0,09/10/2012,Kavli IPMU
shangjun,0,0,0,0,0,09/10/2012,Harvard ITC
ccesarsky,0,0,0,0,0,09/10/2012,CEA Saclay
gfmiller,0,0,0,0,0,09/10/2012,Harvard ITC
fbastien,0,0,0,0,0,09/10/2012,Vanderbilt
cabyrdfisher,0,0,0,0,0,09/10/2012,Vanderbilt
giancarlo_pace,0,0,0,0,0,09/11/2012,unaffiliated
JGold,0,0,0,0,0,09/11/2012,unaffiliated
afrancko,0,0,0,0,0,09/11/2012,Stanford
klk237,0,0,0,0,0,09/12/2012,Stony Brook
Liu Dezi,0,0,0,0,0,09/14/2012,PKU
uros,0,0,0,0,0,09/15/2012,UCB
zvlah,0,0,0,0,0,09/17/2012,Zürich
teppei,0,0,0,0,0,09/17/2012,UCB
alex223,0,0,0,0,0,09/18/2012,unaffiliated
rmalexan,0,0,0,0,0,09/18/2012,Johns Hopkins
partialobs,0,0,0,0,0,09/19/2012,Penn State
youhuachu,0,0,0,0,0,09/19/2012,unaffiliated
kcpan,0,0,0,0,0,09/19/2012,unaffiliated
shant.baghramian,0,0,0,0,0,09/20/2012,unaffiliated
craigmc,0,0,0,0,0,09/20/2012,University of Rochester
SunneD,0,0,0,0,0,09/20/2012,unaffiliated
sfogerty,0,0,0,0,0,09/21/2012,University of Rochester
davidjeffery,0,0,0,0,0,09/21/2012,UNLV
Z_MA,0,0,0,0,0,09/21/2012,unaffiliated
rwebbink,0,0,0,0,0,09/21/2012,UIUC
baror,0,0,0,0,0,09/23/2012,unaffiliated
ehmsps,0,0,0,0,0,09/24/2012,unaffiliated
chenjj,0,0,0,0,0,09/25/2012,Columbia
hilbert,0,0,0,0,0,09/26/2012,MPA Garching
ajuarez,0,0,0,0,0,09/26/2012,UT Austin
mjkim,0,0,0,0,0,09/26/2012,KASI
jmulchaey,0,0,0,0,0,09/26/2012,Carnegie
ustcjnac,0,0,0,0,0,09/26/2012,Carnegie
st4rry3y3d,0,0,0,0,0,09/28/2012,ASU Astro
CosmoTheorist,0,0,0,0,0,09/28/2012,Stanford
jack,0,0,0,0,0,09/28/2012,Stanford
dannycjacobs,0,0,0,0,0,09/28/2012,ASU Astro
wrinnes,0,0,0,0,1,09/28/2012,Stanford
cpd,0,0,0,0,0,09/28/2012,Stanford
zqhsfz,0,0,0,0,0,09/28/2012,Stanford
gbcaminha,0,0,0,0,0,10/01/2012,unaffiliated
Yu-Cian Hong,0,0,0,0,0,10/01/2012,Cornell
mariana,0,0,0,0,0,10/02/2012,unaffiliated
Demonstro,0,0,0,0,0,10/03/2012,UCSC
dpow,0,0,0,0,0,10/03/2012,Stanford
ossowicki,0,0,0,0,0,10/03/2012,DARK
lauren,0,0,0,0,0,10/03/2012,Vanderbilt
juna,0,0,0,0,0,10/03/2012,Carnegie
jlchr,0,0,0,0,0,10/04/2012,unaffiliated
norabolig,0,0,0,0,0,10/04/2012,University of Florida
mistaj,0,0,0,0,0,10/05/2012,Yale
Joseph_K,0,0,0,0,0,10/06/2012,unaffiliated
amorisco nc,0,0,0,0,0,10/08/2012,DARK
Matty,0,0,0,0,0,10/09/2012,DoA PKU
djsissom,0,0,0,0,0,10/09/2012,Vanderbilt
chicago31415,0,0,0,0,0,10/09/2012,unaffiliated
maoshiliu,0,0,0,0,0,10/10/2012,PKU
jsm,0,0,0,0,0,10/10/2012,unaffiliated
katiekate,0,0,0,0,0,10/10/2012,Harvard ITC
pzukin,0,0,0,0,0,10/10/2012,UCB
vabruce,0,0,0,0,0,10/11/2012,Edinburgh
sportillo,0,0,0,0,0,10/11/2012,Harvard ITC
michal,0,0,0,0,0,10/11/2012,Edinburgh
jaehwan,0,0,0,0,0,10/12/2012,Stanford
jgeorge,0,0,0,0,0,10/15/2012,University of Maryland
rrmonje,0,0,0,0,0,10/15/2012,unaffiliated
ronballouz,0,0,0,0,0,10/15/2012,University of Maryland
sheejong,0,0,0,0,0,10/15/2012,UCB
clouse2,0,0,0,0,0,10/15/2012,UIUC
figueroa,0,0,0,0,0,10/16/2012,Geneva Cosmology Group
denbod,0,0,0,0,0,10/16/2012,University of Maryland
Gregory Paciga,0,0,0,0,0,10/16/2012,UofT
wilmar. cardona,0,0,0,0,0,10/16/2012,Geneva Cosmology Group
jma,0,0,0,0,0,10/16/2012,UofT
MichaelWilliams,0,0,0,0,0,10/16/2012,UofT
subodh,0,0,0,0,0,10/16/2012,Geneva Cosmology Group
shariff,0,0,0,0,0,10/17/2012,UofT
laurie711,0,0,0,0,0,10/17/2012,"IfA, University of Hawaii"
lf84,0,0,0,0,0,10/17/2012,Durham University
RaySharples,0,0,0,0,0,10/17/2012,Durham University
SimonLMorris,0,0,0,0,0,10/17/2012,Durham University
csf,0,0,0,0,0,10/18/2012,Durham University
msullivan,0,0,0,0,0,10/18/2012,University of Southampton
Aidan Glennie,0,0,0,0,0,10/18/2012,University of Southampton
retha,0,0,0,0,0,10/18/2012,unaffiliated
oparry,0,0,0,0,0,10/18/2012,University of Maryland
mischa,0,0,0,0,0,10/18/2012,Gemini-South
ftombesi,0,0,0,0,0,10/18/2012,University of Maryland
cdirks,0,0,0,0,0,10/19/2012,CIERA
Helen,0,0,0,0,0,10/19/2012,University of Southampton
SMC,0,0,0,0,0,10/19/2012,Durham University
drewhogg,0,0,0,0,0,10/19/2012,unaffiliated
ricotti,0,0,0,0,0,10/19/2012,University of Maryland
salbi,0,0,0,0,0,10/22/2012,UofT
jwilson,0,0,0,0,0,10/22/2012,Durham University
jtaw,0,0,0,0,0,10/22/2012,Durham University
beermalc,0,0,0,0,0,10/22/2012,University of Washington
ndxf34,0,0,0,0,0,10/23/2012,Durham University
guotsuan,0,0,0,0,0,10/23/2012,Durham University
carla,0,0,0,0,0,10/24/2012,University of Vienna
shp,0,0,0,0,0,10/24/2012,Edinburgh
JohnPeacock,0,0,0,0,0,10/24/2012,Edinburgh
dobbs,0,0,0,0,0,10/24/2012,unaffiliated
guarato,0,0,0,0,0,10/25/2012,Geneva Cosmology Group
Liz Bartlett,0,0,0,0,0,10/25/2012,University of Southampton
ajbird,0,0,0,0,0,10/25/2012,University of Southampton
camelyao,0,0,0,0,0,10/25/2012,DoA PKU
michaeljohnson,0,0,0,0,0,10/30/2012,UCSB
Elad Zinger,0,0,0,0,0,10/31/2012,Hebrew University
markd,0,0,0,0,0,10/31/2012,Hebrew University
pfwu,0,0,0,0,0,11/02/2012,unaffiliated
tonysohn,0,0,0,0,0,11/02/2012,STScI/JHU
laurenst,0,0,0,0,0,11/02/2012,"IfA, University of Hawaii"
adm,0,0,0,0,0,11/05/2012,Durham University
lboldt,0,0,0,0,0,11/06/2012,AIfA
mbrunner,0,0,0,0,0,11/07/2012,University of Vienna
Yiran Wang,0,0,0,0,0,11/07/2012,UIUC
xgal,0,0,0,0,0,11/07/2012,Vanderbilt
nye17,0,0,0,0,0,11/07/2012,unaffiliated
suh,0,0,0,0,0,11/07/2012,"IfA, University of Hawaii"
Grace,0,0,0,0,0,11/08/2012,University of Southampton
WendaZhang,0,0,0,0,0,11/08/2012,unaffiliated
Fiore Cagnetta,0,0,0,0,0,11/12/2012,ETH-Extragalactic
hippoh,0,0,0,0,0,11/13/2012,unaffiliated
kwoodley,0,0,0,0,1,11/14/2012,UCSC
lmocanu,0,0,0,0,0,11/16/2012,Chicago-KICP
highzclouds,0,0,0,0,0,11/16/2012,Chicago-KICP
fwhigh,0,0,0,0,0,11/16/2012,Chicago-KICP
smills,0,0,0,0,0,11/16/2012,Chicago-KICP
stephen_hoover,0,0,0,0,0,11/16/2012,Chicago-KICP
daniel,0,0,0,0,0,11/16/2012,Chicago-KICP
Srinivasan Raghunathan,0,0,0,0,0,11/18/2012,University of Chile-DFI
anna.nelles,0,0,0,0,0,11/19/2012,Radboud University Nijmegen
twijnen,0,0,0,0,0,11/19/2012,Radboud University Nijmegen
aminvox,0,0,0,0,0,11/19/2012,Radboud University Nijmegen
smeingast,0,0,0,0,0,11/19/2012,University of Vienna
afinn,0,0,0,0,0,11/20/2012,DIAS
msmith,0,0,0,0,0,11/21/2012,Gemini-South
tanajoseph,0,0,0,0,0,11/21/2012,unaffiliated
agarciahernandez,0,0,0,0,1,11/23/2012,CAUP
trakht,0,0,0,0,0,11/25/2012,unaffiliated
dcohen,0,0,0,0,0,11/26/2012,University of Chile-DFI
maddoug,0,0,0,0,0,11/26/2012,CEA Saclay High Energy
luca,0,0,0,0,0,11/28/2012,AIfA
ryancooke,0,0,0,0,4,11/29/2012,UCSC
brafax,0,0,0,0,0,11/29/2012,unaffiliated
1nposey,0,0,0,0,0,11/29/2012,unaffiliated
beaylott,0,0,0,0,0,11/29/2012,University of Birmingham
gbaiwen,0,0,0,0,0,11/29/2012,University of Maryland
idental1,0,0,0,0,0,12/04/2012,unaffiliated
mnichols,0,0,0,0,0,12/06/2012,unaffiliated
Vincent Geers,0,0,0,0,0,12/06/2012,DIAS
ladysadie9,0,0,0,0,0,12/06/2012,University of Southampton
Donna,0,0,0,0,0,12/07/2012,unaffiliated
onping,0,0,0,0,0,12/10/2012,unaffiliated
Donna Lee,0,0,0,0,0,12/10/2012,DIAS
shkolnik,0,0,0,0,0,12/10/2012,Lowell Observatory
TheMattMalloy,0,0,0,0,0,12/12/2012,UPenn
MatthewGMalloy,0,0,0,0,0,12/12/2012,UPenn
lmaurin,0,0,0,0,0,12/12/2012,unaffiliated
kat,0,0,0,0,0,12/13/2012,University of Birmingham
jaemin,0,0,0,0,0,12/13/2012,unaffiliated
vahe,0,0,0,0,0,12/14/2012,Stanford
shuang,0,0,0,0,0,12/15/2012,unaffiliated
chal,0,0,0,0,0,12/18/2012,PKU
alis,0,0,0,0,3,12/18/2012,UCSC
Renate,0,0,0,0,0,12/19/2012,AIfA-Cosmo
german,0,0,0,0,0,12/19/2012,Gemini-South
fuerst,0,0,0,0,0,12/25/2012,unaffiliated
nhuntwalker,0,0,0,0,0,01/03/2013,University of Washington
coreyarice80,0,0,0,0,0,01/04/2013,Zürich
fghfdgfdg,0,0,0,0,0,01/04/2013,unaffiliated
spearson,0,0,0,0,0,01/06/2013,DARK
bracine,0,0,0,0,0,01/10/2013,unaffiliated
lenfreeman,0,0,0,0,0,01/10/2013,Cambridge
reina,0,0,0,0,0,01/11/2013,Chicago-KICP
dagfghhgjh,0,0,0,0,0,01/12/2013,unaffiliated
adin,0,0,0,0,0,01/12/2013,Columbia
jpdl_astro_physics,0,0,0,0,0,01/12/2013,Yale
hinchaus,0,0,0,0,0,01/14/2013,APC
krittapas,0,0,0,0,0,01/14/2013,University of Florida
wsaftly,0,0,0,0,0,01/14/2013,Ghent University
Aaron,0,0,0,0,0,01/15/2013,Michigan State
MikeSimonsen,0,0,0,0,0,01/16/2013,unaffiliated
mingsun,0,0,0,0,0,01/16/2013,Yale
ga.braganca,0,0,0,0,0,01/17/2013,unaffiliated
norita113,0,0,0,0,0,01/17/2013,Hebrew University
mariomorado,0,0,0,0,0,01/17/2013,unaffiliated
Thomas_T,0,0,0,0,0,01/18/2013,unaffiliated
Diana Valverde M,0,0,0,0,0,01/18/2013,Universidad de Costa Rica
ggentile,0,0,0,0,0,01/21/2013,Ghent University
zepf,0,0,0,0,0,01/21/2013,Michigan State
ryanhickox,0,0,0,0,0,01/21/2013,Dartmouth College
erinomalley,0,0,0,0,0,01/21/2013,Dartmouth College
phcrane,0,0,0,0,0,01/21/2013,unaffiliated
maherhome,0,0,0,0,0,01/22/2013,NASA Goddard Space Flight Center
minzastro,0,0,0,0,0,01/22/2013,unaffiliated
chaboyer,0,0,0,0,0,01/24/2013,Dartmouth College
Stefano_Marchesi,0,0,0,0,0,01/24/2013,Dartmouth College
thorstensen,0,0,0,0,0,01/24/2013,Dartmouth College
erekalper,0,0,0,0,0,01/24/2013,Dartmouth College
Gary Wegner,0,0,0,0,0,01/24/2013,Dartmouth College
japacheco,0,0,0,0,0,01/24/2013,Universidad de Costa Rica
marcobocchio,0,0,0,0,0,01/25/2013,IAS Orsay - ISM
tuhin,0,0,0,0,0,01/25/2013,IAS Orsay - ISM
abracco,0,0,0,0,0,01/25/2013,IAS Orsay - ISM
afontana,0,0,0,0,0,01/25/2013,INAF-OAR
Winny,0,0,0,0,0,01/25/2013,INAF-OAR
pjohns,0,0,0,0,0,01/25/2013,Lowell Observatory
Avijeet,0,0,0,0,0,01/26/2013,IIA
csblack,0,0,0,0,0,01/26/2013,Dartmouth College
mdas,0,0,0,0,0,01/28/2013,IIA
aboesch,0,0,0,0,0,01/28/2013,unaffiliated
ffiore,0,0,0,0,0,01/28/2013,INAF-OAR
tomchris,0,0,0,0,0,01/29/2013,unaffiliated
prash,0,0,0,0,0,01/29/2013,IIA
cmaceroni,0,0,0,0,0,01/29/2013,INAF-OAR
Bruny,0,0,0,0,0,01/29/2013,unaffiliated
jones.mack,0,0,0,0,0,01/29/2013,Dartmouth College
aubourg,0,0,0,0,0,01/29/2013,APC
dsadasd,0,0,0,0,0,01/29/2013,unaffiliated
jdm,0,0,0,0,0,01/29/2013,NRAO Charlottesville
sschnee,0,0,0,0,0,01/29/2013,NRAO Charlottesville
Sowmya,0,0,0,0,0,01/30/2013,IIA
esaury,0,0,0,0,0,01/30/2013,IAS Orsay - ISM
avivofir,0,0,0,0,0,01/31/2013,unaffiliated
nortmann,0,0,0,0,0,01/31/2013,UniGoettingen
iermolli,0,0,0,0,0,02/01/2013,INAF-OAR
hogg,0,0,0,0,0,02/01/2013,University of Maryland
voit,0,0,0,0,0,02/01/2013,Michigan State
ihook,0,0,0,0,0,02/04/2013,INAF-OAR
Paul,0,0,0,0,0,02/04/2013,NRAO Charlottesville
molly.clairemont,0,0,0,0,0,02/04/2013,Michigan State
Jose Onorbe,0,0,0,0,0,02/04/2013,unaffiliated
Thejs B,0,0,0,0,0,02/05/2013,DARK
jrodmann,0,0,0,0,0,02/05/2013,unaffiliated
Mikkel O. Lindholmer,0,0,0,0,0,02/05/2013,DARK
sel7pa,0,0,0,0,0,02/05/2013,NRAO Charlottesville
sangeetha,0,0,0,0,0,02/05/2013,IIA
dachrist,0,0,0,0,0,02/05/2013,unaffiliated
dbalser,0,0,0,0,0,02/05/2013,NRAO Charlottesville
markadams,0,0,0,0,0,02/05/2013,NRAO Charlottesville
bmason72,0,0,0,0,0,02/05/2013,NRAO Charlottesville
rindebet,0,0,0,0,0,02/05/2013,NRAO Charlottesville
hdsupriya,0,0,0,0,0,02/06/2013,IIA
aistrate,0,0,0,0,0,02/06/2013,AIfA
mariano,0,0,0,0,0,02/06/2013,Universidad de Costa Rica
duncanc,0,0,0,0,0,02/06/2013,NRAO Charlottesville
joshw,0,0,0,0,0,02/07/2013,"IfA, University of Hawaii"
noelianoel,0,0,0,0,0,02/08/2013,University of Surrey
jerseyhawaii,0,0,0,0,0,02/09/2013,unaffiliated
ecb,0,0,0,0,0,02/10/2013,unaffiliated
amoullet,0,0,0,0,0,02/11/2013,NRAO Charlottesville
paglione,0,0,0,0,0,02/11/2013,AMNH
Yannick Giraud-Heraud,0,0,0,0,0,02/13/2013,APC
hamilton,0,0,0,0,0,02/13/2013,unaffiliated
zahariad,0,0,0,0,0,02/14/2013,APC
Jerry,0,0,0,0,0,02/15/2013,Universidad de Costa Rica
susanna,0,0,0,0,0,02/15/2013,Osservatorio Astrofisico di Arcetri - Extragalactic
scarniani,0,0,0,0,0,02/16/2013,Osservatorio Astrofisico di Arcetri - Extragalactic
norbert,0,0,0,0,0,02/18/2013,"IfA, University of Hawaii"
tribiano,0,0,0,0,0,02/20/2013,MIT
mengsu,0,0,0,0,0,02/20/2013,MIT
cweber,0,0,0,0,0,02/21/2013,University of Vienna
ruxandrab7,0,0,0,0,0,02/21/2013,Zürich
astrowahl,0,0,0,0,0,02/21/2013,Stony Brook
sophia,0,0,0,0,0,02/22/2013,unaffiliated
beibei,0,0,0,0,0,02/23/2013,unaffiliated
sasikumarraja,0,0,0,0,0,02/27/2013,IIA
pentra,0,0,0,0,0,02/27/2013,INAF-OAR
dtucker@fnal.gov,0,0,0,0,0,02/28/2013,Fermilab
wyatt,0,0,0,0,0,02/28/2013,Fermilab
rklanza,0,0,0,0,0,02/28/2013,Fermilab
Datao Wang,0,0,0,0,0,03/01/2013,PKU
yoo,0,0,0,0,0,03/01/2013,Fermilab
lauram74,0,0,0,0,0,03/01/2013,Osservatorio Astrofisico di Arcetri - Extragalactic
mwiesner,0,0,0,0,0,03/01/2013,Fermilab
mbuckley,0,0,0,0,0,03/03/2013,Fermilab
amr,0,0,0,0,0,03/04/2013,Durham University
mpetersen,0,0,0,0,0,03/04/2013,U. Mass
ChrisBeaumont,0,0,0,0,0,03/04/2013,unaffiliated
salvesen,0,0,0,0,0,03/07/2013,CU Boulder
Mari,0,0,0,0,0,03/07/2013,unaffiliated
jie.wang,0,0,0,0,0,03/12/2013,Durham University
kdleschinski,0,0,0,0,0,03/12/2013,University of Vienna
john.b.alcorn,0,0,0,0,0,03/14/2013,NASA Goddard Space Flight Center
humberto,0,0,0,0,0,03/14/2013,Universidad de Costa Rica
kdevaraj,0,0,0,0,0,03/15/2013,Stanford
Sasha,0,0,0,0,0,03/18/2013,Universidad de Costa Rica
Maxi,0,0,0,0,0,03/18/2013,University of Southampton
klk23789,0,0,0,0,0,03/18/2013,Stony Brook
Emmanuel,0,0,0,0,0,03/18/2013,CEA Saclay
orianne_roos,0,0,0,0,0,03/18/2013,CEA Saclay
rpuebla,0,0,0,0,0,03/19/2013,U. Pittsburgh
akuepper,0,0,0,0,0,03/20/2013,unaffiliated
biancapoggianti,0,0,0,0,0,03/21/2013,unaffiliated
milica.micic,0,0,0,0,0,03/21/2013,AOB
ks,0,0,0,0,0,03/21/2013,PKU
ekshicks,0,0,0,0,0,03/22/2013,unaffiliated
passamontiA,0,0,0,0,0,03/25/2013,INAF-OAR
Izaskun,0,0,0,0,0,03/26/2013,"U. de Concepcion: Planetary, Stellar, Galactic, Extragalactic papers"
blackdragonae,0,0,0,0,0,03/27/2013,unaffiliated
abbycrites,0,0,0,0,0,03/27/2013,Chicago-KICP
pierre.G,0,0,0,0,0,03/28/2013,APC
passmann,0,0,0,0,0,03/28/2013,"U. de Concepcion: Planetary, Stellar, Galactic, Extragalactic papers"
maasr,0,0,0,0,0,04/01/2013,University of Washington
pmisson,0,0,0,0,0,04/02/2013,UCM
ccunha,0,0,0,0,0,04/03/2013,Stanford
nahee,0,0,0,0,0,04/03/2013,Chicago-KICP
monicacolpi,0,0,0,0,0,04/04/2013,University of Milano-Bicocca
ross.fanali,0,0,0,0,0,04/05/2013,unaffiliated
goldwurm,0,0,0,0,0,04/10/2013,CEA Saclay High Energy
RicardoQ,0,0,0,0,0,04/13/2013,Universidad de Costa Rica
dbrenner,0,0,0,0,0,04/14/2013,unaffiliated
mschrinn,0,0,0,0,1,04/15/2013,UniGoettingen
altair,0,0,0,0,0,04/15/2013,University of Milano-Bicocca
yefengdan,0,0,0,0,0,04/16/2013,KIAA-Clusters
idelooze,0,0,0,0,0,04/17/2013,Ghent University
tullia.sbarrato,0,0,0,0,0,04/19/2013,University of Milano-Bicocca
cakeger,0,0,0,0,0,04/22/2013,unaffiliated
Valentina,0,0,0,0,0,04/25/2013,Zürich
doulm,0,0,0,0,0,04/25/2013,unaffiliated
jquark,0,0,0,0,0,04/25/2013,Vanderbilt
kuncarayakti,0,0,0,0,0,04/28/2013,Kavli IPMU
santiago.viquez,0,0,0,0,0,04/30/2013,Universidad de Costa Rica
cm89,0,0,0,0,0,04/30/2013,University of Milano-Bicocca
pj,0,0,0,0,0,05/01/2013,unaffiliated
ferrara,0,0,0,0,0,05/02/2013,unaffiliated
hsinyuc,0,0,0,0,0,05/02/2013,Chicago-KICP
dpcarrasco,0,0,0,0,0,05/03/2013,McGill
chihway,0,0,0,0,0,05/07/2013,Stanford
karliner,0,0,0,0,0,05/08/2013,UIUC
ahojjati,0,0,0,0,0,05/09/2013,unaffiliated
Thibaut Roger,0,0,0,0,0,05/10/2013,UniGoettingen
Milena.Guevara,0,0,0,0,0,05/10/2013,Universidad de Costa Rica
TheresaSharp2,0,0,0,0,0,05/13/2013,unaffiliated
ScotyH,0,0,0,0,0,05/14/2013,LJMU
KWilk,0,0,0,0,0,05/14/2013,U. Pittsburgh
sjo32,0,0,0,0,0,05/14/2013,Stanford
ioav,0,0,0,0,0,05/17/2013,UFRJ
llhsu,0,0,0,0,0,05/20/2013,Fermilab
aravinda,0,0,0,0,0,05/21/2013,unaffiliated
ajd.ender,0,0,0,0,0,05/22/2013,Edinburgh
scottdodelson,0,0,0,0,0,05/23/2013,Fermilab
dritan,0,0,0,0,0,05/23/2013,unaffiliated
vinicius_miranda,0,0,0,0,0,05/28/2013,Chicago-KICP
lpcinelli,0,0,0,0,0,05/29/2013,UFRJ
Fabio.,0,0,0,0,0,05/30/2013,Universidad de Costa Rica
somak,0,0,0,0,0,05/30/2013,University of Birmingham
gianluca,0,0,0,0,0,05/30/2013,INAF-OAR
ikatkov,0,0,0,0,0,06/01/2013,unaffiliated
kstewart,0,0,0,0,0,06/04/2013,UCI
eman,0,0,0,0,0,06/05/2013,unaffiliated
YianniTamanas,0,0,0,0,0,06/06/2013,Rutgers
nbutcher,0,0,0,0,0,06/07/2013,Michigan State
adhabal,0,0,0,0,0,06/07/2013,NASA Goddard Space Flight Center
kbandura,0,0,0,0,0,06/07/2013,McGill
cbsilver,0,0,0,0,0,06/10/2013,Michigan State
jobryan,0,0,0,0,0,06/12/2013,UCI
hojjati,0,0,0,0,0,06/13/2013,UCB
cnatario,0,0,0,0,0,06/16/2013,University of Hertfordshire
carlanatario,0,0,0,0,0,06/16/2013,unaffiliated
nancyhine,0,0,0,0,0,06/17/2013,unaffiliated
dsaez,0,0,0,0,0,06/18/2013,CEA Saclay High Energy
ymchoi,0,0,0,0,0,06/21/2013,unaffiliated
pritesh,0,0,0,0,0,06/21/2013,IUCAA
huachabei731,0,0,0,0,0,06/24/2013,unaffiliated
Sharon,0,0,0,0,0,06/27/2013,Harvard ITC
frantaky,0,0,0,0,0,06/27/2013,Gemini-South
xizhang,0,0,0,0,0,07/01/2013,Caltech
wfong,0,0,0,0,0,07/05/2013,Harvard ITC
syph,0,0,0,0,0,07/05/2013,unaffiliated
mathewm,0,0,0,0,0,07/08/2013,Stony Brook
jschureman,0,0,0,0,0,07/08/2013,Chicago-KICP
smei,0,0,0,0,0,07/09/2013,Observatory of Paris
mhoenig,0,0,0,0,0,07/09/2013,Gemini-North
bcole,0,0,0,0,0,07/09/2013,Gemini-North
olai,0,0,0,0,0,07/09/2013,Gemini-North
eberkson,0,0,0,0,0,07/09/2013,Gemini-North
jmiller,0,0,0,0,0,07/09/2013,Gemini-North
amcnicho,0,0,0,0,0,07/09/2013,Gemini-North
KrisFedorenko,0,0,0,0,0,07/09/2013,Gemini-North
inger,0,0,0,0,0,07/10/2013,Gemini-North
Mark Durre,0,0,0,0,0,07/16/2013,Swinburne
themiyan,0,0,0,0,0,07/16/2013,Swinburne
kobelev,0,0,0,0,0,07/16/2013,unaffiliated
omar,0,0,0,0,0,07/16/2013,unaffiliated
EarthSize,0,0,0,0,0,07/16/2013,unaffiliated
bmetcalf,0,0,0,0,0,07/17/2013,University of Bologna
pato,0,0,0,0,0,07/22/2013,Cornell
micol,0,0,0,0,0,07/23/2013,University of Bologna
lmagill,0,0,0,0,0,07/23/2013,Gemini-South
bconn,0,0,0,0,0,07/23/2013,Gemini-South
swoodapple,0,0,0,0,0,07/23/2013,UCB
meithan,0,0,0,0,0,07/23/2013,ICN-UNAM
davidad,0,0,0,0,0,07/23/2013,ICN-UNAM
tcosta,0,0,0,0,0,07/24/2013,Cambridge
voxchris12345,0,0,0,0,0,07/25/2013,LJMU
tcurrie,0,0,0,0,0,07/25/2013,unaffiliated
nlharr,0,0,0,0,0,07/25/2013,UCB
Richard Beare,0,0,0,0,0,07/25/2013,MoCA
jjedrusiak,0,0,0,0,0,07/26/2013,unaffiliated
chenhou,0,0,0,0,0,07/29/2013,UMN
shantanu,0,0,0,0,0,07/29/2013,unaffiliated
edoberger,0,0,0,0,0,07/29/2013,Harvard ITC
Chen,0,0,0,0,0,07/30/2013,MoCA
smineo,0,0,0,0,0,07/30/2013,Durham University
sirio,0,0,0,0,0,07/30/2013,Caltech
mciotola,0,0,0,0,0,07/31/2013,MoCA
intertwistlet,0,0,0,0,0,07/31/2013,Georgia Tech
sloebman,0,0,0,0,0,07/31/2013,University of Washington
cdoherty,0,0,0,0,0,08/05/2013,MoCA
TBDTommieav,0,0,0,0,0,08/06/2013,unaffiliated
bug,0,0,0,0,0,08/07/2013,IUCAA
Simon Campbell,0,0,0,0,0,08/08/2013,MoCA
cagarland,0,0,0,0,0,08/12/2013,AMNH
smarchi,0,0,0,0,0,08/12/2013,unaffiliated
hillier,0,0,0,0,0,08/15/2013,unaffiliated
mislavb,0,0,0,0,0,08/21/2013,Caltech
stephanb,0,0,0,0,0,08/22/2013,SIfA
mcmonigal,0,0,0,0,0,08/22/2013,SIfA
hareth,0,0,0,0,0,08/22/2013,SIfA
chowen,0,0,0,0,0,08/22/2013,RSAA-ANU
jdru4706,0,0,0,0,0,08/22/2013,SIfA
Lisa Fogarty,0,0,0,0,0,08/22/2013,unaffiliated
ralphemorgan,0,0,0,0,0,08/22/2013,SIfA
charley,0,0,0,0,0,08/23/2013,RSAA-ANU
sarah,0,0,0,0,0,08/23/2013,SIfA
ahagen,0,0,0,0,0,08/25/2013,Penn State
webster,0,0,0,0,0,08/26/2013,SIfA
shane,0,0,0,0,0,08/26/2013,SIfA
SNR,0,0,0,0,0,08/26/2013,SIfA
bhuwan,0,0,0,0,0,08/26/2013,SIfA
ElaineSadler,0,0,0,0,0,08/26/2013,SIfA
nscott,0,0,0,0,0,08/26/2013,unaffiliated
rperea,0,0,0,0,0,08/26/2013,unaffiliated
pz,0,0,0,0,0,08/27/2013,SIfA
earnric,0,0,0,0,0,08/28/2013,ASU Astro
amberstraughn,0,0,0,0,0,08/28/2013,NASA GSFC Extragalactic
itjung,0,0,0,0,0,08/28/2013,UT Austin
jpedley,0,0,0,0,0,08/29/2013,MoCA
elenc,0,0,0,0,0,08/29/2013,SIfA
k.coppin,0,0,0,0,0,08/30/2013,University of Hertfordshire
dop13,0,0,0,0,0,08/31/2013,U. Pittsburgh
jrobbfed,0,0,0,0,0,09/01/2013,unaffiliated
veronica.arias,0,0,0,0,0,09/02/2013,unaffiliated
ldf_astro,0,0,0,0,0,09/02/2013,Valongo Observatory
hubble,0,0,0,0,0,09/03/2013,CEA Saclay
cactus,0,0,0,0,0,09/03/2013,unaffiliated
susanstewart,0,0,0,0,0,09/03/2013,Vanderbilt
monica,0,0,0,0,0,09/03/2013,UIUC
chenge5000,0,0,0,0,0,09/04/2013,KIAA-Clusters
akutyrev,0,0,0,0,0,09/04/2013,University of Maryland
cherie,0,0,0,0,0,09/04/2013,RSAA-ANU
jsikes,0,0,0,0,0,09/04/2013,Georgia Tech
Katherine Lee,0,0,0,0,0,09/05/2013,University of Maryland
junhwanchoi,0,0,0,0,0,09/05/2013,UT Austin
trw,0,0,0,0,0,09/06/2013,UNLV
lkngcgub,0,0,0,0,0,09/07/2013,unaffiliated
sazpark,0,0,0,0,0,09/07/2013,UCSC
conken,0,0,0,0,0,09/08/2013,RSAA-ANU
jbryant,0,0,0,0,0,09/08/2013,SIfA
diegolorenzo,0,0,0,0,0,09/09/2013,Valongo Observatory
gerbortolotto,0,0,0,0,0,09/09/2013,UFSC (GAS)
rrbernardi,0,0,0,0,0,09/09/2013,UFSC (GAS)
bohuali,0,0,0,0,0,09/09/2013,UT Austin
tforrest,0,0,0,0,0,09/09/2013,Georgia Tech
anat,0,0,0,0,0,09/10/2013,U. Pittsburgh
petrucci,0,0,0,0,0,09/10/2013,unaffiliated
Mariano,0,0,0,0,0,09/10/2013,CEFCA
karlen,0,0,0,0,0,09/10/2013,UMN
straka,0,0,0,0,0,09/11/2013,unaffiliated
sarrvesh,0,0,0,0,0,09/11/2013,unaffiliated
hvr,0,0,0,0,0,09/12/2013,CEFCA
hmeheut,0,0,0,0,0,09/12/2013,CEA Saclay High Energy
sabrina,0,0,0,0,0,09/12/2013,NRAO Charlottesville
benopp99,0,0,0,0,0,09/12/2013,CU Boulder
Steve Kloster,0,0,0,0,0,09/13/2013,SFU
aliojjati,0,0,0,0,0,09/13/2013,SFU
sstanchfield,0,0,0,0,0,09/13/2013,unaffiliated
Siddi,0,0,0,0,0,09/14/2013,unaffiliated
wood,0,0,0,0,0,09/16/2013,UW Madison
eboettcher,0,0,0,0,0,09/16/2013,UW Madison
akundert,0,0,0,0,0,09/16/2013,UW Madison
rmathieu,0,0,0,0,0,09/16/2013,UW Madison
Yun Li,0,0,0,0,0,09/17/2013,SFU
yoasthull,0,0,0,0,0,09/17/2013,UW Madison
kilian,0,0,0,0,0,09/17/2013,unaffiliated
mccann,0,0,0,0,0,09/17/2013,Chicago-KICP
conormcp,0,0,0,0,0,09/18/2013,"IfA, University of Hawaii"
skg,0,0,0,0,0,09/18/2013,"IfA, University of Hawaii"
yulinzhao128,0,0,0,0,0,09/18/2013,KIAA-Clusters
sorour,0,0,0,0,0,09/18/2013,"U. of Sussex, Astronomy Centre"
alicem,0,0,0,0,0,09/18/2013,Edinburgh
rh320,0,0,0,0,0,09/18/2013,"U. of Sussex, Astronomy Centre"
lwang83,0,0,0,0,0,09/20/2013,unaffiliated
Jon Loveday,0,0,0,0,0,09/20/2013,"U. of Sussex, Astronomy Centre"
Ed Churchwell,0,0,0,0,0,09/20/2013,UW Madison
none,0,0,0,0,0,09/20/2013,unaffiliated
marinaorio,0,0,0,0,0,09/21/2013,UW Madison
nbatalha,0,0,0,0,0,09/23/2013,Penn State
rwade653,0,0,0,0,0,09/23/2013,Penn State
wangxin,0,0,0,0,0,09/23/2013,STScI/JHU
barger,0,0,0,0,0,09/23/2013,UW Madison
klein,0,0,0,0,0,09/23/2013,Carnegie Mellon University
Shirley Ho,0,0,0,0,0,09/24/2013,Carnegie Mellon University
alawrence,0,0,0,0,0,09/25/2013,UW Madison
dleier,0,0,0,0,0,09/25/2013,University of Bologna
astrodoo,0,0,0,0,0,09/25/2013,UW Madison
bob31415,0,0,0,0,0,09/25/2013,UW Madison
astroj,0,0,0,0,0,09/25/2013,UW Madison
alexhp,0,0,0,0,0,09/25/2013,UCB
edinnat,0,0,0,0,0,09/26/2013,NASA Goddard Space Flight Center
mclampin,0,0,0,0,0,09/26/2013,NASA Goddard Space Flight Center
chkvch,0,0,0,0,0,09/26/2013,UCSC
bobbenjamin,0,0,0,0,0,09/26/2013,UW Madison
cercer,0,0,0,0,0,09/27/2013,NASA Goddard Space Flight Center
ryon,0,0,0,0,0,09/27/2013,UW Madison
deovrat,0,0,0,0,0,09/30/2013,IISc-RRI
ahernandez,0,0,0,0,0,09/30/2013,UW Madison
bwhitney,0,0,0,0,0,09/30/2013,UW Madison
jcbrooks,0,0,0,0,0,10/01/2013,UCSB
burdanov.art,0,0,0,0,0,10/01/2013,UniGoettingen
khrrubin,0,0,0,0,0,10/01/2013,Harvard ITC
jisuoqing,0,0,0,0,0,10/01/2013,UCSB
mikesmith1611,0,0,0,0,0,10/02/2013,University of Hertfordshire
fabian.schussler,0,0,0,0,0,10/02/2013,CEA Saclay High Energy
PierreBrun,0,0,0,0,0,10/02/2013,CEA Saclay High Energy
emoulin,0,0,0,0,0,10/02/2013,CEA Saclay High Energy
rcawthon,0,0,0,0,0,10/02/2013,Chicago-KICP
ruiy,0,0,0,0,0,10/03/2013,MoCA
garima.singh,0,0,0,0,0,10/03/2013,Observatory of Paris
ryanleaman,0,0,0,0,0,10/03/2013,IAC
jorge sanchez almeida,0,0,0,0,0,10/03/2013,IAC
klagyi,0,0,0,0,0,10/03/2013,IAC
df,0,0,0,0,0,10/03/2013,IAC
johnbeckman,0,0,0,0,0,10/03/2013,IAC
ZYLin,0,0,0,0,0,10/03/2013,SHAO
prakritipc,0,0,0,0,0,10/03/2013,IISc-RRI
astrosapiens,0,0,0,0,0,10/03/2013,KNU
pere.l.palle,0,0,0,0,0,10/04/2013,IAC
mbeasley,0,0,0,0,0,10/04/2013,IAC
ras,0,0,0,0,0,10/04/2013,IAC
fgrise,0,0,0,0,0,10/04/2013,IAC
kmbandura,0,0,0,0,0,10/04/2013,McGill
callende,0,0,0,0,0,10/06/2013,IAC
rterrien,0,0,0,0,0,10/07/2013,Penn State
JRees,0,0,0,0,0,10/07/2013,University of Exeter
tjharries,0,0,0,0,0,10/07/2013,University of Exeter
MonchoReyRaposo,0,0,0,0,0,10/07/2013,University of Exeter
jbulger,0,0,0,0,0,10/07/2013,ASU Astro
imartin,0,0,0,0,0,10/07/2013,unaffiliated
ueejeong.jeong,0,0,0,0,0,10/07/2013,KNU
mservice,0,0,0,0,0,10/07/2013,"IfA, University of Hawaii"
clint,0,0,0,0,0,10/07/2013,UCSB
DanielPfenniger,0,0,0,0,0,10/08/2013,IHP
tremaine,0,0,0,0,0,10/08/2013,UCB
Franz Joseph K.u.K.,0,0,0,0,0,10/09/2013,University of Vienna
SanderMooij,0,0,0,0,0,10/09/2013,University of Chile-DFI
mpereira,0,0,0,0,0,10/09/2013,Arizona
hughes,0,0,0,0,0,10/09/2013,unaffiliated
wangliang,0,0,0,0,0,10/10/2013,unaffiliated
BlackHole,0,0,0,0,0,10/10/2013,Nanjing University
puresky,0,0,0,0,0,10/10/2013,Nanjing University
stfyou,0,0,0,0,0,10/10/2013,Nanjing University
paolot68,0,0,0,0,0,10/10/2013,unaffiliated
elrond,0,0,0,0,0,10/10/2013,Nanjing University
RWB,0,0,0,0,0,10/10/2013,unaffiliated
ymkoala,0,0,0,0,0,10/10/2013,unaffiliated
Haiyang,0,0,0,0,0,10/10/2013,Nanjing University
Laura Watkins,0,0,0,0,0,10/10/2013,STScI/JHU
giuliov,0,0,0,0,0,10/10/2013,University of Hertfordshire
vardan,0,0,0,0,0,10/10/2013,IHP
subash,0,0,0,0,0,10/10/2013,IHP
tigerlee,0,0,0,0,0,10/10/2013,Chicago-KICP
gaisuan,0,0,0,0,0,10/11/2013,Nanjing University
imn,0,0,0,0,0,10/11/2013,unaffiliated
sbsaikia,0,0,0,0,0,10/11/2013,UniGoettingen
kimberlystar,0,0,0,0,0,10/11/2013,Penn State
d.acreman,0,0,0,0,0,10/11/2013,University of Exeter
sj,0,0,0,0,0,10/11/2013,UT Austin
RuthAngus,0,0,0,0,0,10/11/2013,Oxford University - Galaxies
ypwang,0,0,0,0,0,10/12/2013,Nanjing University
quantumkit,0,0,0,0,0,10/13/2013,ASIAA
oaiqq,0,0,0,0,0,10/13/2013,Nanjing University
Anshu,0,0,0,0,0,10/13/2013,RSAA-ANU
davidsam,0,0,0,0,0,10/14/2013,University of Exeter
tc1415,0,0,0,0,0,10/14/2013,University of Exeter
adc,0,0,0,0,0,10/14/2013,University of Exeter
xinwang,0,0,0,0,0,10/15/2013,UCSB
jTrayford,0,0,0,0,0,10/15/2013,unaffiliated
Sander TV,0,0,0,0,0,10/15/2013,Radboud University Nijmegen
xunda7,0,0,0,0,0,10/16/2013,GMRT-science
albertzheng,0,0,0,0,0,10/16/2013,Nanjing University
smcmuldroch,0,0,0,0,0,10/16/2013,Harvard ITC
dcnguyen,0,0,0,0,0,10/16/2013,University of Rochester
das@cfa.harvard.edu,0,0,0,0,0,10/16/2013,Harvard ITC
lsironi,0,0,0,0,0,10/16/2013,Harvard ITC
hhancock,0,0,0,0,0,10/16/2013,UCSC
fsienkiewicz,0,0,0,0,0,10/16/2013,Harvard ITC
agoodman,0,0,0,0,0,10/16/2013,Harvard ITC
sundarsrinivasan,0,0,0,0,0,10/17/2013,ASIAA
sunway,0,0,0,0,0,10/17/2013,Nanjing University
robitaille,0,0,0,0,0,10/17/2013,MPIA
lc208,0,0,0,0,0,10/17/2013,"U. of Sussex, Astronomy Centre"
Nimesh Patel,0,0,0,0,0,10/17/2013,Harvard ITC
pmiles,0,0,0,0,0,10/18/2013,IAC
brian,0,0,0,0,0,10/18/2013,DARK
damon,0,0,0,0,0,10/18/2013,DARK
yfeijin,0,0,0,0,0,10/18/2013,Nanjing University
wbrown,0,0,0,0,0,10/18/2013,Harvard ITC
mmdunham,0,0,0,0,0,10/18/2013,Harvard ITC
lwatson,0,0,0,0,0,10/18/2013,Harvard ITC
augustmuench,0,0,0,0,0,10/18/2013,Harvard ITC
deisenstein,0,0,0,0,0,10/18/2013,Harvard ITC
jsteiner,0,0,0,0,0,10/18/2013,Harvard ITC
cmcbride,0,0,0,0,0,10/21/2013,Harvard ITC
dwilner,0,0,0,0,0,10/21/2013,Harvard ITC
purpledwarf,0,0,0,0,0,10/21/2013,IAC
srandall,0,0,0,0,0,10/21/2013,Harvard ITC
ryan,0,0,0,0,0,10/21/2013,UCR
brad,0,0,0,0,0,10/21/2013,RSAA-ANU
sukhdeep,0,0,0,0,0,10/22/2013,Carnegie Mellon University
arlewis,0,0,0,0,0,10/23/2013,University of Washington
jslavin,0,0,0,0,0,10/24/2013,Harvard ITC
Martin Elvis,0,0,0,0,0,10/24/2013,Harvard ITC
dweisz,0,0,0,0,1,10/24/2013,UCSC
Diane Turnshek,0,0,0,0,0,10/24/2013,Carnegie Mellon University
sci.chris,0,0,0,0,0,10/25/2013,University of Washington
sgontcho,0,0,0,0,0,10/25/2013,ICCUB
mperrin,0,0,0,0,0,10/25/2013,STScI/JHU
zz3x7,0,0,0,0,0,10/25/2013,Stanford
stuart.marshall,0,0,0,0,0,10/25/2013,Stanford
tchang,0,0,0,0,0,10/28/2013,ASIAA
mws,0,0,0,0,0,10/28/2013,"IfA, University of Hawaii"
Diego Capozzi,0,0,0,0,0,10/28/2013,ICG Portsmouth
craiganderson,0,0,0,0,0,10/29/2013,SIfA
gongbo,0,0,0,0,0,10/29/2013,ICG Portsmouth
atrivi,0,0,0,0,0,10/31/2013,IAC
Marcos,0,0,0,0,0,10/31/2013,UW Madison
mahlers,0,0,0,0,0,10/31/2013,WIPAC
Kexin Guo,0,0,0,0,0,10/31/2013,PMO
Joshuam,0,0,0,0,0,11/01/2013,McGill
cra,0,0,0,0,0,11/01/2013,IAC
lgreenhill,0,0,0,0,0,11/01/2013,Harvard ITC
broni_1,0,0,0,0,0,11/02/2013,ICG Portsmouth
sjmurphy,0,0,0,0,0,11/03/2013,SIfA
victoriag,0,0,0,0,0,11/04/2013,MIT
cello625,0,0,0,0,0,11/05/2013,University of Amsterdam
kimk,0,0,0,0,0,11/05/2013,ETH-Extragalactic
nnielsen,0,0,0,0,0,11/06/2013,NMSU
Yongbeom Kang,0,0,0,0,0,11/07/2013,Johns Hopkins
ricamorin,0,0,0,0,0,11/07/2013,INAF-OAR
hmartindale,0,0,0,0,0,11/07/2013,"U. of Sussex, Astronomy Centre"
sborosaikia,0,0,0,0,0,11/07/2013,UniGoettingen
gorellana,0,0,0,0,0,11/08/2013,CEA Saclay
ksteakley,0,0,0,0,0,11/08/2013,NMSU
cjvargas,0,0,0,0,0,11/11/2013,NMSU
markert,0,0,0,0,0,11/11/2013,NMSU
edd,0,0,0,0,0,11/11/2013,ICG Portsmouth
Mieke Paalvast,0,0,0,0,0,11/12/2013,Leiden
gdomenech,0,0,0,0,0,11/12/2013,ICCUB
benderan,0,0,0,0,0,11/13/2013,McGill
twaters,0,0,0,0,0,11/14/2013,UNLV
vbosch,0,0,0,0,0,11/14/2013,ICCUB
briedel,0,0,0,0,0,11/14/2013,WIPAC
athelen,0,0,0,0,0,11/14/2013,NMSU
Torben,0,0,0,0,0,11/18/2013,SAC
kaemin,0,0,0,0,0,11/18/2013,CEA Saclay
astrorunner,0,0,0,0,0,11/19/2013,NAOC
syfeng,0,0,0,0,0,11/19/2013,MPIA
pathall,0,0,0,0,0,11/19/2013,York University
bruntt@gmail.com,0,0,0,0,0,11/21/2013,SAC
mark,0,0,0,0,0,11/21/2013,US Naval Observatory
Eric,0,0,0,0,0,11/21/2013,US Naval Observatory
qtan,0,0,0,0,0,11/22/2013,PMO
hinowashi,0,0,0,0,0,11/22/2013,U. Michigan
cwu,0,0,0,0,0,11/22/2013,NMSU
dkwak1,0,0,0,0,0,11/24/2013,MoCA
zwliu,0,0,0,0,0,11/25/2013,AIfA
james.hilton,0,0,0,0,0,11/26/2013,US Naval Observatory
r.j.wilkinson,0,0,0,0,0,11/26/2013,Durham University
etacar11,0,0,0,0,0,11/26/2013,US Naval Observatory
elkopi,0,0,0,0,0,11/27/2013,Edinburgh
michel,0,0,0,0,0,11/27/2013,INAF-OAR
ranl,0,0,0,0,0,11/29/2013,NAOC
Elisa,0,0,0,0,0,11/30/2013,University of Milano-Bicocca
Jia Junyi,0,0,0,0,0,12/02/2013,NAOC
chen qingxiang,0,0,0,0,0,12/03/2013,NAOC
wang qiao,0,0,0,0,0,12/03/2013,NAOC
amir,0,0,0,0,0,12/03/2013,Hebrew University
tomarmstrong,0,0,0,0,0,12/03/2013,Durham University
gao,0,0,0,0,0,12/03/2013,NAOC
seurban,0,0,0,0,0,12/03/2013,US Naval Observatory
mrodrigues,0,0,0,0,0,12/04/2013,Observatory of Paris
otiss192000,0,0,0,0,0,12/04/2013,Carnegie
seanmatt,0,0,0,0,0,12/09/2013,University of Exeter
surya,0,0,0,0,0,12/09/2013,RSAA-ANU
FanLiu,0,0,0,0,0,12/10/2013,PMO
gb,0,0,0,0,0,12/13/2013,University of Hertfordshire
lvertatschtisch,0,0,0,0,0,12/13/2013,Harvard ITC
henrysgg,0,0,0,0,0,12/13/2013,Penn State
ydai,0,0,0,0,0,12/13/2013,Caltech
davidharris,0,0,0,0,0,12/14/2013,University of Utah
ybli,0,0,0,0,0,12/15/2013,PMO
barber,0,0,0,0,0,12/16/2013,University of Utah
leungtszkuk,0,0,0,0,0,12/17/2013,UCB
sedemink,0,0,0,0,0,12/19/2013,Carnegie
cphu,0,0,0,0,0,12/26/2013,SHAO
rominsky,0,0,0,0,0,01/02/2014,Fermilab
evan1022,0,0,0,0,0,01/06/2014,UCB
wyeh,0,0,0,0,0,01/07/2014,NAOC
benjbromley,0,0,0,0,0,01/07/2014,University of Utah
earendil,0,0,0,0,0,01/08/2014,University of Milano-Bicocca
borgani,0,0,0,0,0,01/09/2014,OATS
delucia,0,0,0,0,0,01/09/2014,OATS
Gudy,0,0,0,0,0,01/09/2014,University of Milano-Bicocca
Nadia_91,0,0,0,0,0,01/09/2014,University of Milano-Bicocca
bolton,0,0,0,0,0,01/09/2014,University of Utah
silvyb,0,0,0,0,0,01/09/2014,University of Milano-Bicocca
tellesbo,0,0,0,0,0,01/09/2014,University of Utah
gradbrad,0,0,0,0,0,01/10/2014,University of Utah
Daiana Filloramo,0,0,0,0,0,01/10/2014,University of Milano-Bicocca
Sarettah,0,0,0,0,0,01/10/2014,University of Milano-Bicocca
nothengh,0,0,0,0,0,01/10/2014,University of Utah
kolbylyn,0,0,0,0,0,01/12/2014,Boston University
jpage2010,0,0,0,0,0,01/12/2014,Florida Tech
MatteoLucchini,0,0,0,0,0,01/12/2014,University of Milano-Bicocca
giuseppe,0,0,0,0,0,01/12/2014,University of Milano-Bicocca
f.giudici9,0,0,0,0,0,01/13/2014,University of Milano-Bicocca
rmcentaf,0,0,0,0,0,01/13/2014,University of Iowa
casey-deroo,0,0,0,0,0,01/13/2014,University of Iowa
spangler,0,0,0,0,0,01/13/2014,University of Iowa
Kenneth F nicholson,0,0,0,0,0,01/14/2014,Caltech
ncrocket,0,0,0,0,0,01/14/2014,Caltech
akirkpatrick,0,0,0,0,0,01/14/2014,UMass Amherst
chris.ahn,0,0,0,0,0,01/15/2014,University of Utah
danmil,0,0,0,0,0,01/15/2014,Harvard ITC
vikrant,0,0,0,0,0,01/15/2014,University of Utah
jonathanpseale,0,0,0,0,0,01/16/2014,Johns Hopkins
agianninas,0,0,0,0,0,01/16/2014,University of Oklahoma
papadopa,0,0,0,0,0,01/17/2014,ICG Portsmouth
AndreasP,0,0,0,0,0,01/17/2014,ICG Portsmouth
Liszthi,0,0,0,0,0,01/20/2014,Georgia Tech
salberts,0,0,0,0,0,01/20/2014,UMass Amherst
cxi,0,0,0,0,0,01/21/2014,University of Waterloo
chengyu,0,0,0,0,0,01/21/2014,University of Waterloo
tjpage,0,0,0,0,0,01/21/2014,University of Iowa
crthibodeau,0,0,0,0,0,01/21/2014,UMass Amherst
mgbenoit,0,0,0,0,0,01/21/2014,UMass Amherst
bstetzler,0,0,0,0,0,01/21/2014,University of Oklahoma
Xiayu Liu,0,0,0,0,0,01/22/2014,University of Iowa
erin_m_cooper,0,0,0,0,0,01/22/2014,University of Oklahoma
schonfsj,0,0,0,0,0,01/23/2014,NMSU
sowgat,0,0,0,0,0,01/23/2014,Penn State
soumavo,0,0,0,0,0,01/23/2014,IISc-RRI
sbrough,0,0,0,0,0,01/23/2014,AAO
Jonathan Merritt,0,0,0,0,0,01/24/2014,MoCA
twenger,0,0,0,0,0,01/24/2014,NRAO Charlottesville
valda,0,0,0,0,0,01/27/2014,SISSA
bacci,0,0,0,0,0,01/27/2014,SISSA
ebusekool,0,0,0,0,0,01/27/2014,Kapteyn-HI
monicahuang,0,0,0,0,0,01/28/2014,UIUC-SF
dlopez,0,0,0,0,0,01/28/2014,SISSA
nfruscia,0,0,0,0,0,01/28/2014,SISSA
emassara,0,0,0,0,0,01/28/2014,SISSA
matteo.martinelli,0,0,0,0,0,01/28/2014,SISSA
Othatawong,0,0,0,0,0,01/28/2014,University of Heidelberg ITP/ITA
abelen,0,0,0,0,0,01/28/2014,SISSA
jvavra,0,0,0,0,0,01/28/2014,Stanford
jlustigy,0,0,0,0,0,01/29/2014,UCSC
jmwittrock,0,0,0,0,0,01/29/2014,University of Iowa
wilsoncd,0,0,0,0,0,01/31/2014,NRAO Charlottesville
mauramcl,0,0,0,0,0,02/02/2014,WVU
ngiese,0,0,0,0,0,02/02/2014,Kapteyn-HI
drl,0,0,0,0,0,02/03/2014,WVU
ashking,0,0,0,0,0,02/03/2014,U. Michigan
Daeseong,0,0,0,0,0,02/03/2014,UCI
filippo,0,0,0,0,0,02/04/2014,Kapteyn-HI
yiannis,0,0,0,0,0,02/04/2014,Kapteyn-HI
frgs,0,0,0,0,0,02/04/2014,ICCUB
gcongedo,0,0,0,0,0,02/05/2014,Oxford University - Galaxies
damonge,0,0,0,0,0,02/05/2014,Oxford University - Galaxies
BorisHaeussler,0,0,0,0,0,02/05/2014,Oxford University - Galaxies
djpisano,0,0,0,0,0,02/05/2014,WVU
brjohnstone,0,0,0,0,0,02/05/2014,WVU
ytwu,0,0,0,0,0,02/06/2014,ASIAA
awall,0,0,0,0,0,02/06/2014,Lehigh University
candaceg,0,0,0,0,0,02/06/2014,NMSU
srinath,0,0,0,0,0,02/07/2014,UCSC Outflows
giada,0,0,0,0,0,02/07/2014,University of Washington
swolfe,0,0,0,0,0,02/07/2014,WVU
alexisf,0,0,0,0,0,02/07/2014,University of Maryland
av,0,0,0,0,0,02/10/2014,Oxford University - Galaxies
gabriele.trevisan,0,0,0,0,0,02/10/2014,SISSA
miguelzuma,0,0,0,0,0,02/10/2014,University of Heidelberg ITP/ITA
byuhas,0,0,0,0,0,02/10/2014,Lehigh University
tstatler,0,0,0,0,0,02/10/2014,University of Maryland
Bruno,0,0,0,0,0,02/10/2014,Valongo Observatory
llevin,0,0,0,0,0,02/10/2014,WVU
ngosnell,0,0,0,0,0,02/10/2014,UT Austin
colinorman,0,0,0,0,0,02/10/2014,STScI-AGN
acheetham,0,0,0,0,0,02/11/2014,SIfA
Georgios,0,0,0,0,0,02/11/2014,University of Southampton
nbourne2,0,0,0,0,0,02/11/2014,Edinburgh
ki,0,0,0,0,0,02/11/2014,ICCUB
athena_ranice,0,0,0,0,0,02/11/2014,UCB
laurennc,0,0,0,0,0,02/12/2014,Columbia
affadi,0,0,0,0,0,02/12/2014,UWC
SantiRoca,0,0,0,0,0,02/13/2014,ICCUB
salucci,0,0,0,0,0,02/13/2014,SISSA
k22white,0,0,0,0,0,02/13/2014,University of Waterloo
nagueda,0,0,0,0,0,02/14/2014,ICCUB
ddelser,0,0,0,0,0,02/14/2014,ICCUB
mljones,0,0,0,0,0,02/14/2014,WVU
millie.maier,0,0,0,0,0,02/17/2014,AAO
marcochiab,0,0,0,0,0,02/17/2014,STScI-AGN
Yong,0,0,0,0,0,02/18/2014,Columbia
Kimmy Wu,0,0,0,0,0,02/18/2014,Stanford
nkhandai,0,0,0,0,0,02/18/2014,Carnegie Mellon University
glicenstein,0,0,0,0,0,02/19/2014,CEA Saclay High Energy
andrea.belfiore,0,0,0,0,0,02/21/2014,unaffiliated
eliu,0,0,0,0,0,02/24/2014,WVU
austin,0,0,0,0,0,02/25/2014,Chicago-KICP
nhwang,0,0,0,0,0,02/26/2014,KASI
space7time,0,0,0,0,0,02/26/2014,KASI
jaemann,0,0,0,0,0,02/26/2014,KASI
ysjo,0,0,0,0,0,02/26/2014,KASI
sckim,0,0,0,0,0,02/26/2014,KASI
chr,0,0,0,0,0,02/26/2014,KASI
jclee,0,0,0,0,0,02/26/2014,KASI
hyunjin,0,0,0,0,0,02/26/2014,KASI
GOUIFFES,0,0,0,0,0,02/26/2014,CEA Saclay High Energy
Hye-Ran Lee,0,0,0,0,0,02/26/2014,KASI
haoyang,0,0,0,0,0,02/26/2014,Arizona
flaviasobreira,0,0,0,0,0,02/27/2014,Fermilab
sastanchfield,0,0,0,0,0,02/27/2014,UPenn
msyriac,0,0,0,0,0,03/03/2014,Stony Brook
aleonard,0,0,0,0,0,03/04/2014,CEA Saclay CosmoStat
gaccurfso,0,0,0,0,0,03/04/2014,unaffiliated
rtunnard,0,0,0,0,0,03/04/2014,unaffiliated
asaintonge,0,0,0,0,0,03/04/2014,unaffiliated
npfl,0,0,0,0,0,03/06/2014,AAO
angelcastro0111,0,0,0,0,0,03/07/2014,IA-UNAM Ensenada
nlourie,0,0,0,0,0,03/07/2014,UPenn
beaylott1986,0,0,0,0,0,03/07/2014,University of Birmingham
antonkoekemoer,0,0,0,0,0,03/07/2014,STScI/JHU
Frozen,0,0,0,0,0,03/07/2014,UMN
abhimat,0,0,0,0,0,03/09/2014,UCB
kaurov,0,0,0,0,0,03/09/2014,Fermilab
wantyou,0,0,0,0,0,03/11/2014,ESO Chile
abanerjee,0,0,0,0,0,03/12/2014,IUCAA
jamiefarnes,0,0,0,0,0,03/12/2014,SIfA
vicmaestro,0,0,0,0,0,03/12/2014,SIfA
shagstotz,0,0,0,0,0,03/12/2014,University of Heidelberg ITP/ITA
tisserand,0,0,0,0,0,03/12/2014,IAP Cosmology and Extragalactic
sandreas,0,0,0,0,0,03/12/2014,IAP Cosmology and Extragalactic
vennin,0,0,0,0,0,03/12/2014,unaffiliated
Alba Vidal Garcia,0,0,0,0,0,03/12/2014,IAP Cosmology and Extragalactic
Quentin,0,0,0,0,0,03/13/2014,CEA Saclay High Energy
vitenti,0,0,0,0,0,03/13/2014,IAP Cosmology and Extragalactic
adonnarum,0,0,0,0,0,03/14/2014,IAP Cosmology and Extragalactic
leborgne,0,0,0,0,0,03/14/2014,IAP Cosmology and Extragalactic
kburns,0,0,0,0,0,03/14/2014,MIT
Yi Mao,0,0,0,0,0,03/14/2014,IAP Cosmology and Extragalactic
RebeccaMc,0,0,0,0,0,03/16/2014,SIfA
charlot,0,0,0,0,0,03/17/2014,IAP Cosmology and Extragalactic
michelevi,0,0,0,0,0,03/17/2014,IAP Cosmology and Extragalactic
hjmcc,0,0,0,0,0,03/17/2014,IAP Cosmology and Extragalactic
renaux,0,0,0,0,0,03/17/2014,IAP Cosmology and Extragalactic
ejmartin,0,0,0,0,0,03/18/2014,Chicago-KICP
blima,0,0,0,0,0,03/18/2014,SISSA
non.son.io,0,0,0,0,0,03/18/2014,IAP Cosmology and Extragalactic
Dan Dicken,0,0,0,0,0,03/18/2014,CEA Saclay
pitrou,0,0,0,0,0,03/18/2014,IAP Cosmology and Extragalactic
dalerojo,0,0,0,0,0,03/18/2014,INAF-OAR
sheldon campbell,0,0,0,0,0,03/19/2014,OSU Astronomy
rwpogge,0,0,0,0,0,03/19/2014,OSU Astronomy
MostlyHarmless,0,0,0,0,0,03/20/2014,OSU Astronomy
liuchaonaoc,0,0,0,0,0,03/20/2014,NAOC
amaury,0,0,0,0,0,03/20/2014,CEA Saclay
bsgaudi,0,0,0,0,0,03/20/2014,OSU Astronomy
weizhu,0,0,0,0,0,03/20/2014,OSU Astronomy
dhw,0,0,0,0,0,03/20/2014,OSU Astronomy
IgnacioVega,0,0,0,0,0,03/21/2014,University of Hertfordshire
sudeshna,0,0,0,0,0,03/21/2014,UniGoettingen
mairensaro,0,0,0,0,0,03/21/2014,Radboud University Nijmegen
rousselhe,0,0,0,0,0,03/21/2014,IAP Cosmology and Extragalactic
ehuff,0,0,0,0,0,03/21/2014,OSU Astronomy
faus,0,0,0,0,0,03/23/2014,OSU Astronomy
mosquera,0,0,0,0,0,03/23/2014,OSU Astronomy
satadru,0,0,0,0,0,03/24/2014,IUCAA
sjs,0,0,0,0,0,03/25/2014,OSU Astronomy
MoritzM,0,0,0,0,0,03/25/2014,IAP Cosmology and Extragalactic
tlichtenberg,0,0,0,0,0,03/27/2014,UniGoettingen
Saoussen Mbarek,0,0,0,0,0,03/28/2014,University of Waterloo
simianman,0,0,0,0,0,03/28/2014,OSU Astronomy
cblake,0,0,0,0,0,03/28/2014,UPenn
bredhaddin000,0,0,0,0,0,03/29/2014,ASU Astro
apatruno,0,0,0,0,0,03/29/2014,Leiden
plira,0,0,0,0,0,03/31/2014,UChile - Calan
noelinjm,0,0,0,0,0,04/01/2014,OATS
wayne0308,0,0,0,0,0,04/01/2014,unaffiliated
iary,0,0,0,0,0,04/01/2014,University of Bologna
Zhijian Luo,0,0,0,0,0,04/01/2014,UChile - Calan
tqwon,0,0,0,0,0,04/02/2014,Nanjing University
afurniss,0,0,0,0,0,04/02/2014,Stanford
klaguana,0,0,0,0,0,04/03/2014,University of Hawaii at Hilo
sarastanchfield,0,0,0,0,0,04/04/2014,UPenn
arguelles,0,0,0,0,0,04/04/2014,WIPAC
mangilli,0,0,0,0,0,04/08/2014,IAP Cosmology and Extragalactic
tolstov,0,0,0,0,0,04/08/2014,Kavli IPMU
agbruce,0,0,0,0,0,04/08/2014,Edinburgh
vish,0,0,0,0,0,04/08/2014,IAP Cosmology and Extragalactic
devonhollowood,0,0,0,0,0,04/08/2014,UCSC-HEP
K_Sapountzis,0,0,0,0,0,04/08/2014,unaffiliated
haruka kusakabe,0,0,0,0,0,04/10/2014,University of Tokyo
asvarov,0,0,0,0,0,04/10/2014,unaffiliated
jfb,0,0,0,0,0,04/14/2014,UCSD
pisani,0,0,0,0,0,04/14/2014,IAP Cosmology and Extragalactic
Ghazal,0,0,0,0,0,04/14/2014,Perimeter Institute for Theoretical Physics
Becca.Anne.Robinson,0,0,0,0,0,04/14/2014,Clemson
mcortes,0,0,0,0,0,04/14/2014,Perimeter Institute for Theoretical Physics
aescala,0,0,0,0,0,04/15/2014,UChile - Calan
latham,0,0,0,0,0,04/15/2014,Perimeter Institute for Theoretical Physics
sbritt,0,0,0,0,0,04/15/2014,Clemson
nicks,0,0,0,0,0,04/15/2014,University of Utah
Ryota Kawamata,0,0,0,0,0,04/17/2014,University of Tokyo
J. Utreras,0,0,0,0,0,04/17/2014,UChile - Calan
minju.sophie,0,0,0,0,0,04/18/2014,unaffiliated
wiphu,0,0,0,0,0,04/18/2014,Kavli IPMU
bin.ren,0,0,0,0,0,04/18/2014,Johns Hopkins
ncanac,0,0,0,0,0,04/21/2014,UCI
manset,0,0,0,0,0,04/23/2014,CFHT
nhmc,0,0,0,0,0,04/24/2014,Swinburne
jmichea,0,0,0,0,0,04/24/2014,PUC-Institute of Astrophysics
rosalita,0,0,0,0,0,04/25/2014,ICCUB
ecunning,0,0,0,0,0,04/25/2014,UCSC
abaldi,0,0,0,0,0,04/28/2014,Michigan State
lgilbert,0,0,0,0,0,04/28/2014,Caltech
joshuawallace,0,0,0,0,0,04/28/2014,unaffiliated
gordonm,0,0,0,0,0,04/29/2014,NMSU
vpota,0,0,0,0,1,04/30/2014,UCSC
Ignacio.Vega,0,0,0,0,0,04/30/2014,University of Hertfordshire
Jeancarlos,0,0,0,0,0,05/01/2014,Universidad de Costa Rica
ptb,0,0,0,0,0,05/02/2014,NOA
Stefania,0,0,0,0,0,05/03/2014,DARK
jacobsvensmark,0,0,0,0,0,05/05/2014,DARK
flanigan,0,0,0,0,0,05/06/2014,Columbia
akiyama,0,0,0,0,0,05/12/2014,unaffiliated
CLSteinhardt,0,0,0,0,0,05/12/2014,Caltech
joshspeagle,0,0,0,0,0,05/12/2014,Harvard ITC
saraellison,0,0,0,0,0,05/13/2014,unaffiliated
JoaoP,0,0,0,0,0,05/14/2014,UFRJ
JoaoPGV,0,0,0,0,0,05/14/2014,UFRJ
jchiang,0,0,0,0,0,05/17/2014,Stanford
jvictoria,0,0,0,0,0,05/19/2014,FSU Astrophysics
Rodrigo,0,0,0,0,0,05/19/2014,"U. de Concepcion: Planetary, Stellar, Galactic, Extragalactic papers"
ahsonnenschein,0,0,0,0,0,05/19/2014,Fermilab
binchen,0,0,0,0,0,05/19/2014,FSU Astrophysics
varumugam,0,0,0,0,0,05/23/2014,ESO Garching
ioteo,0,0,0,0,0,05/23/2014,unaffiliated
durever,0,0,0,0,0,05/23/2014,CEA Saclay
AdamB,0,0,0,0,0,05/24/2014,Texas A&M
jjasche,0,0,0,0,0,05/27/2014,IAP Cosmology and Extragalactic
zenada,0,0,0,0,0,05/27/2014,Boston University
timstaley2,0,0,0,0,0,05/27/2014,unaffiliated
lacerda,0,0,0,0,0,05/27/2014,UFSC (GAS)
yh_Wu,0,0,0,0,0,05/28/2014,NTHU
elenat,0,0,0,0,0,05/28/2014,Osservatorio Astrofisico di Arcetri - Extragalactic
joao_paulo,0,0,0,0,0,05/29/2014,UFRJ
mwolk,0,0,0,0,0,05/29/2014,"IfA, University of Hawaii"
leigh,0,0,0,0,0,05/30/2014,University of Hertfordshire
vrapson,0,0,0,0,0,05/30/2014,RIT
sheroze1123,0,0,0,0,0,06/03/2014,Cornell-Cosmo
sowmyak,0,0,0,0,0,06/06/2014,Stanford
jaclynbradli,0,0,0,0,0,06/09/2014,Cornell
s.marchesi,0,0,0,0,0,06/11/2014,Yale
gmontes,0,0,0,0,1,06/12/2014,UCSC
zbb,0,0,0,0,0,06/12/2014,unaffiliated
unaffiliated,0,0,0,0,0,06/13/2014,Boston University
adeich,0,0,0,0,0,06/16/2014,University of Utah
lshadler,0,0,0,0,0,06/17/2014,RIT
varun,0,0,0,0,0,06/18/2014,IUCAA
mraives,0,0,0,0,0,06/18/2014,Caltech
jeongws,0,0,0,0,0,06/23/2014,KASI
somade,0,0,0,0,0,06/24/2014,ETH-Extragalactic
shar,0,0,0,0,0,06/24/2014,Hebrew University
matt.stephens,0,0,0,0,0,06/24/2014,University of Utah
Olga Tihhonova,0,0,0,0,0,06/26/2014,EPFL - UniGe
alvarcl,0,0,0,0,0,06/26/2014,Stanford
irod973,0,0,0,0,0,06/26/2014,Stanford
cjburke,0,0,0,0,0,06/27/2014,Yale-Planets
aurelia,0,0,0,0,0,06/27/2014,Rutgers
npr,0,0,0,0,0,06/27/2014,Edinburgh
Jonghwan,0,0,0,0,0,06/30/2014,ICRAR
octavi,0,0,0,0,0,07/02/2014,unaffiliated
weh40,0,0,0,0,0,07/03/2014,U. Pittsburgh
smithmat,0,0,0,0,0,07/03/2014,University of Southampton
IgnacioVegaA,0,0,0,0,0,07/03/2014,University of Hertfordshire
expozito,0,0,0,0,0,07/04/2014,University of Heidelberg ITP/ITA
Trifonov,0,0,0,0,0,07/04/2014,University of Heidelberg ITP/ITA
hari,0,0,0,0,0,07/05/2014,University of Tokyo
rlbeaton,0,0,0,0,0,07/07/2014,Carnegie
Eda Gjergo,0,0,0,0,0,07/07/2014,U. Pittsburgh
blakesherwin,0,0,0,0,0,07/07/2014,UCB
testuseradsfaef23r1,0,0,0,0,0,07/07/2014,unaffiliated
Jordan_Bulkley,0,0,0,0,0,07/07/2014,University of Utah
tkozakis,0,0,0,0,0,07/07/2014,Cornell
dauw,0,0,0,0,0,07/08/2014,NTHU
dimitrios_stamadianos,0,0,0,0,0,07/10/2014,University of Hertfordshire
rjassef,0,0,0,0,0,07/10/2014,UDP
SamMangham,0,0,0,0,0,07/11/2014,University of Southampton
kdirwin,0,0,0,0,0,07/15/2014,Stanford
dodophys,0,0,0,0,0,07/16/2014,ASIAA
Cesar Ini,0,0,0,0,0,07/16/2014,CEFCA
mbalogh,0,0,0,0,0,07/18/2014,University of Waterloo
gretachappell,0,0,0,0,0,07/21/2014,FSU Astrophysics
emmetgm,0,0,0,0,0,07/22/2014,Boston University
lorrivox,0,0,0,0,0,07/28/2014,SFU
DaveJacobs,0,0,0,0,0,07/28/2014,unaffiliated
rcrain,0,0,0,0,0,07/29/2014,Leiden
Borlaff,0,0,0,0,0,07/29/2014,UCM
howardbond,0,0,0,0,0,07/30/2014,Penn State
jderose,0,0,0,0,0,07/30/2014,Stanford
Yu-Hsiang Lin,0,0,0,0,0,07/31/2014,Stanford
zhnhou,0,0,0,0,0,07/31/2014,Chicago-KICP
chahah,0,0,0,0,0,08/01/2014,York University
Gregory Shelton,0,0,0,0,0,08/05/2014,US Naval Observatory
Jorge Manuel Arroyo Campos,0,0,0,0,0,08/06/2014,UCR
slstever,0,0,0,0,0,08/07/2014,AAO
Felipe,0,0,0,0,0,08/07/2014,FSU Astrophysics
asgrob,0,0,0,0,0,08/09/2014,ICRAR
Sean H. Wang,0,0,0,0,0,08/12/2014,RSAA-ANU
Kurt,0,0,0,0,0,08/12/2014,UCT Cosmology
rsmullen,0,0,0,0,0,08/13/2014,Arizona
jiasun,0,0,0,0,0,08/15/2014,unaffiliated
Sebastian,0,0,0,0,0,08/19/2014,UChile - Calan
tkomacek,0,0,0,0,0,08/21/2014,Arizona
damgreen,0,0,0,0,0,08/21/2014,NASA Goddard Space Flight Center
mwhite,0,0,0,0,0,08/22/2014,UCB
Melissa Graham,0,0,0,0,0,08/22/2014,UCB
degroom,0,0,0,0,0,08/22/2014,UCB cosmology
youdin,0,0,0,0,0,08/22/2014,Arizona
yunfanz,0,0,0,0,0,08/22/2014,UCB
amckay,0,0,0,0,0,08/25/2014,UT Austin
davisce3,0,0,0,0,0,08/26/2014,Vanderbilt
kimitake,0,0,0,0,0,08/26/2014,KASI
Vega,0,0,0,0,0,08/26/2014,Vanderbilt
Enric_Juan,0,0,0,0,0,08/26/2014,ICCUB
tommasotreu,0,0,0,0,0,08/26/2014,UCSB
theadmin,0,0,0,0,0,08/26/2014,UW Madison
joannelbl,0,0,0,0,0,08/26/2014,UCB cosmology
yfeng@lbl.gov,0,0,0,0,0,08/26/2014,UCB cosmology
diwen,0,0,0,0,0,08/27/2014,UIUC
andrewn,0,0,0,0,0,08/27/2014,UIUC
wtliao,0,0,0,0,0,08/27/2014,UIUC
eringcox,0,0,0,0,0,08/27/2014,UIUC
clairedickey,0,0,0,0,0,08/27/2014,Yale
danmcginnis,0,0,0,0,0,08/27/2014,University of Iowa
skhoward,0,0,0,0,0,08/27/2014,University of Iowa
Shaun_Steele,0,0,0,0,0,08/27/2014,University of Oklahoma
bellini,0,0,0,0,0,08/27/2014,STScI/JHU
cfielder,0,0,0,0,0,08/28/2014,U. Pittsburgh
Rapunzellindemann,0,0,0,0,0,08/29/2014,unaffiliated
pepito159,0,0,0,0,0,08/30/2014,Carnegie Mellon University
quarkosmos,0,0,0,0,0,09/01/2014,KASI
cmitchell,0,0,0,0,0,09/01/2014,Rutgers
rodigas,0,0,0,0,0,09/01/2014,Carnegie DTM
jlbirkby,0,0,0,0,0,09/02/2014,Harvard ITC
lyung,0,0,0,0,0,09/02/2014,Rutgers
Paula Lopez,0,0,0,0,0,09/02/2014,UChile - Calan
diegoaltamirano,0,0,0,0,0,09/03/2014,University of Southampton
aycin,0,0,0,0,0,09/04/2014,Georgia Tech
craney,0,0,0,0,0,09/04/2014,Rutgers
hche,0,0,0,0,0,09/04/2014,University of Maryland
pgatkine,0,0,0,0,0,09/04/2014,University of Maryland
zero,0,0,0,0,0,09/04/2014,University of Maryland
Dana Louie,0,0,0,0,0,09/04/2014,University of Maryland
bruno.dias,0,0,0,0,0,09/05/2014,Durham University
azsom,0,0,0,0,0,09/05/2014,MIT Exoplanet Tea
avjohns,0,0,0,0,0,09/05/2014,MIT
lmowla,0,0,0,0,0,09/08/2014,Yale
Flip Tanedo,0,0,0,0,0,09/08/2014,UCI
briaz,0,0,0,0,0,09/08/2014,University of Hertfordshire
yzhou,0,0,0,0,0,09/09/2014,Arizona
mblaychak,0,0,0,0,0,09/09/2014,CFHT
Ilan Manulis,0,0,0,0,0,09/10/2014,Weizmann Institute of Science
Q,0,0,0,0,0,09/10/2014,Georgia Tech
fcapulid,0,0,0,0,0,09/10/2014,University of Waterloo
stark,0,0,0,0,0,09/11/2014,ASIAA
cfroning,0,0,0,0,0,09/11/2014,UT Austin
btkidder,0,0,0,0,0,09/11/2014,UT Austin
jnikoley,0,0,0,0,0,09/12/2014,University of Maryland
donglai,0,0,0,0,0,09/13/2014,Cornell
cdvorkin,0,0,0,0,0,09/14/2014,Harvard ITC
RCochrane,0,0,0,0,0,09/14/2014,Edinburgh
yoni,0,0,0,0,0,09/15/2014,Weizmann Institute of Science
MaurineMUJ,0,0,0,0,0,09/16/2014,University of Southampton
enricob,0,0,0,0,0,09/16/2014,IAP Cosmology and Extragalactic
ojturner,0,0,0,0,0,09/16/2014,Edinburgh
irina,0,0,0,0,0,09/17/2014,IAP Cosmology and Extragalactic
ermaier,0,0,0,0,0,09/17/2014,University of Iowa
xguo,0,0,0,0,0,09/18/2014,Harvard ITC
healy,0,0,0,0,0,09/18/2014,RIT-CCRG
gengm125,0,0,0,0,0,09/19/2014,AIfA
hsyang,0,0,0,0,0,09/19/2014,University of Maryland
danielj,0,0,0,0,0,09/19/2014,Penn State
mcw,0,0,0,0,0,09/19/2014,Exoplanets@Cambridge
teocuz,0,0,0,0,0,09/19/2014,University of Bologna
SusieMauro,0,0,0,0,0,09/21/2014,Rutgers
ElvaUavpueg,0,0,0,0,0,09/21/2014,STScI/JHU
dannykh,0,0,0,0,0,09/22/2014,Weizmann Institute of Science
isak wold,0,0,0,0,0,09/22/2014,UT Austin
sevillan,0,0,0,0,0,09/22/2014,UIUC
akhostov,0,0,0,0,0,09/22/2014,UCR
tom.theuns,0,0,0,0,0,09/23/2014,Durham University
ajb,0,0,0,0,0,09/23/2014,Exoplanets@Cambridge
EternalLight7583,0,0,0,0,0,09/23/2014,UIUC
currie,0,0,0,0,0,09/24/2014,UofT
UteGirardin,0,0,0,0,0,09/24/2014,Fermilab
zhijiequ,0,0,0,0,0,09/24/2014,UCSC
nancygau,0,0,0,0,0,09/25/2014,NTHU
Jean-Luc Krattiger,0,0,0,0,0,09/25/2014,EPFL - UniGe
manuela@CCRG,0,0,0,0,0,09/25/2014,RIT-CCRG
edt,0,0,0,0,0,09/25/2014,UCI
jkamen,0,0,0,0,0,09/26/2014,Arizona
zjs2405,0,0,0,0,0,09/26/2014,RIT-CCRG
tirth,0,0,0,0,0,09/26/2014,NCRA
MaraSalvato,0,0,0,0,0,09/28/2014,unaffiliated
DoreenGant,0,0,0,0,0,09/28/2014,Stanford
ekaterina,0,0,0,0,0,09/29/2014,NTHU
ss7n13,0,0,0,0,0,09/29/2014,University of Southampton
mmhoffman,0,0,0,0,0,09/29/2014,Stony Brook
najita,0,0,0,0,0,09/29/2014,Arizona
chchan,0,0,0,0,0,09/29/2014,Johns Hopkins
motloch,0,0,0,0,0,09/30/2014,Chicago-KICP
sedakaptan,0,0,0,0,0,09/30/2014,Istanbul University
pwhatfield,0,0,0,0,0,10/01/2014,Oxford University - Galaxies
Airam,0,0,0,0,0,10/01/2014,UCB cosmology
hr203,0,0,0,0,0,10/02/2014,"U. of Sussex, Astronomy Centre"
smithandy6592,0,0,0,0,0,10/02/2014,University of Southampton
jmcourt,0,0,0,0,0,10/02/2014,University of Southampton
gseidel,0,0,0,0,0,10/02/2014,MPIA
nuala.mccullagh,0,0,0,0,0,10/03/2014,Durham University
aegge,0,0,0,0,0,10/03/2014,"U. of Sussex, Astronomy Centre"
DonnieJ20otl,0,0,0,0,0,10/05/2014,U. Pittsburgh
yumasr,0,0,0,0,0,10/05/2014,University of Tokyo
fursten2,0,0,0,0,0,10/06/2014,UIUC
abatta,0,0,0,0,0,10/06/2014,UCSC
pjmaline,0,0,0,0,0,10/06/2014,FSU Astrophysics
jclark,0,0,0,0,0,10/06/2014,Georgia Tech
smilline,0,0,0,0,0,10/07/2014,University of Utah
aabergel,0,0,0,0,0,10/08/2014,IAS
Lizhong,0,0,0,0,0,10/08/2014,UIUC
alison mansheim,0,0,0,0,0,10/08/2014,UCD
kohn,0,0,0,0,0,10/08/2014,UCB
sfseiji,0,0,0,0,0,10/09/2014,University of Tokyo
jfensch,0,0,0,0,0,10/10/2014,CEA Saclay
HaiOYNpdxofsz,0,0,0,0,0,10/10/2014,Stanford
jssrs,0,0,0,0,0,10/10/2014,SISSA
Dtdin4,0,0,0,0,0,10/12/2014,MoCA
yueliu,0,0,0,0,0,10/12/2014,UMass Amherst
lverstra,0,0,0,0,0,10/13/2014,IAS Orsay - ISM
george.zhou89,0,0,0,0,0,10/13/2014,RSAA-ANU
JP,0,0,0,0,0,10/13/2014,UCR
mkyildiz,0,0,0,0,0,10/14/2014,Kapteyn-HI
CandraSpielvoge,0,0,0,0,0,10/14/2014,University of Southampton
JackieVilladsen,0,0,0,0,0,10/15/2014,Caltech
David W,0,0,0,0,0,10/16/2014,University of Southampton
Chris Mowat,0,0,0,0,0,10/16/2014,University of Exeter
Karleyne,0,0,0,0,0,10/16/2014,Gemini-South
trujillo,0,0,0,0,0,10/16/2014,Gemini-North
me224,0,0,0,0,0,10/16/2014,"U. of Sussex, Astronomy Centre"
Najmeh,0,0,0,0,0,10/17/2014,UCR
ee,0,0,0,0,0,10/17/2014,Edinburgh
nicolas.tessore,0,0,0,0,0,10/17/2014,University of Bologna
thesunr19,0,0,0,0,0,10/17/2014,ICG Portsmouth
SaraJ,0,0,0,0,0,10/17/2014,LAM
tangmtasua,0,0,0,0,0,10/17/2014,Arizona
dfielding,0,0,0,0,0,10/17/2014,UCB
Camilo F,0,0,0,0,0,10/19/2014,PUC-Institute of Astrophysics
troyraen,0,0,0,0,0,10/20/2014,University of Utah
JMOAN,0,0,0,0,0,10/21/2014,Penn State
Chiao-Yu Lee,0,0,0,0,0,10/21/2014,NTHU
samverstocken,0,0,0,0,0,10/21/2014,Ghent University
zachary.dugan,0,0,0,0,0,10/21/2014,Johns Hopkins
anaacebron,0,0,0,0,0,10/21/2014,LAM
nebblu,0,0,0,0,0,10/22/2014,ICG Portsmouth
marco,0,0,0,0,0,10/22/2014,ICG Portsmouth
hector,0,0,0,0,0,10/22/2014,ICG Portsmouth
Alkistis Pourtsidou,0,0,0,0,0,10/22/2014,ICG Portsmouth
Djosovic,0,0,0,0,0,10/22/2014,AOB
lsenecal,0,0,0,0,0,10/22/2014,ICS
thsyu,0,0,0,0,0,10/22/2014,UCSC
bkkrueger,0,0,0,0,0,10/23/2014,LANL
lduffy,0,0,0,0,0,10/23/2014,LANL
aimeefryer,0,0,0,0,0,10/23/2014,LANL
gsinnis,0,0,0,0,0,10/23/2014,LANL
haack,0,0,0,0,0,10/23/2014,LANL
ITregillis,0,0,0,0,0,10/23/2014,LANL
bkwiggins,0,0,0,0,0,10/23/2014,LANL
mparis,0,0,0,0,0,10/23/2014,LANL
kgbudge,0,0,0,0,0,10/23/2014,LANL
ddefrere,0,0,0,0,0,10/23/2014,Arizona
John Middleditch,0,0,0,0,0,10/24/2014,LANL
kblumy,0,0,0,0,0,10/24/2014,"IfA, University of Hawaii"
JeannaMatthias,0,0,0,0,0,10/27/2014,Arizona
Jeremy.Sakstein,0,0,0,0,0,10/27/2014,ICG Portsmouth
Shiyu Nie,0,0,0,0,0,10/27/2014,University of Utah
plambeck,0,0,0,0,0,10/27/2014,UCB
cqueiroz,0,0,0,0,0,10/28/2014,CEFCA
michaelrosenthal,0,0,0,0,0,10/29/2014,UCSB
john ryan,0,0,0,0,0,10/30/2014,UCSB
giulia,0,0,0,0,0,10/30/2014,UCSB
Laura Wolz,0,0,0,0,0,10/31/2014,University of Melbourne
tanvir88,0,0,0,0,0,10/31/2014,IUCAA
sumana,0,0,0,0,0,10/31/2014,Ghent University
setnof,0,0,0,0,0,10/31/2014,LANL
weseven,0,0,0,0,0,10/31/2014,LANL
schragenm,0,0,0,0,0,10/31/2014,LANL
ranny,0,0,0,0,0,11/02/2014,Weizmann Institute of Science
MiguelMacleay,0,0,0,0,0,11/03/2014,UT Austin
ylvagotberg,0,0,0,0,0,11/03/2014,University of Amsterdam
noralinn,0,0,0,0,0,11/03/2014,Weizmann Institute of Science
sstraal,0,0,0,0,0,11/03/2014,University of Amsterdam
LuciennGsi,0,0,0,0,0,11/03/2014,Stanford
Nima,0,0,0,0,0,11/04/2014,Cornell LEPP-STRINGS
vivek m,0,0,0,0,0,11/05/2014,University of Utah
jgallego,0,0,0,0,0,11/05/2014,UCM
HenrikLatter,0,0,0,0,0,11/06/2014,Exoplanets@Cambridge
MGuenther,0,0,0,0,0,11/06/2014,Exoplanets@Cambridge
samaya,0,0,0,0,0,11/06/2014,Radboud University Nijmegen
Toshihiro Fujii,0,0,0,0,0,11/06/2014,Chicago-KICP
tomasz,0,0,0,0,0,11/06/2014,CRAL
Ronaldpami,0,0,0,0,0,11/07/2014,ASCL
wayne.stimson,0,0,0,0,0,11/07/2014,University of Hertfordshire
pavlidou,0,0,0,0,0,11/07/2014,University of Crete
svmeyer,0,0,0,0,0,11/08/2014,University of Heidelberg ITP/ITA
ydt,0,0,0,0,0,11/09/2014,Cornell LEPP-STRINGS
boris,0,0,0,0,0,11/11/2014,Tartu Obs
tcb63,0,0,0,0,0,11/11/2014,Cornell LEPP-STRINGS
Simón Ángel,0,0,0,0,0,11/11/2014,PUC-Institute of Astrophysics
Jukka,0,0,0,0,0,11/12/2014,Tartu Obs
panopg,0,0,0,0,0,11/12/2014,University of Crete
veganakos,0,0,0,0,0,11/13/2014,UofT
tlihsin,0,0,0,0,0,11/13/2014,Clemson
rgamen,0,0,0,0,0,11/13/2014,Unaffiliated
emiliobellini,0,0,0,0,0,11/14/2014,ICCUB
bobyokidoki,0,0,0,0,0,11/14/2014,University of Hertfordshire
fraihan,0,0,0,0,0,11/14/2014,AIfA-Cosmo
Xianggao Wang,0,0,0,0,0,11/14/2014,UNLV
ahttajdini,0,0,0,0,0,11/16/2014,Cornell LEPP-STRINGS
Paul Lasky,0,0,0,0,0,11/17/2014,MoCA
svats,0,0,0,0,0,11/17/2014,University of Amsterdam
RWolstenhulme,0,0,0,0,0,11/17/2014,Unaffiliated
sladjana,0,0,0,0,0,11/17/2014,Weizmann Institute of Science
matthewdavis9179,0,0,0,0,0,11/18/2014,UCSC
joseph,0,0,0,0,0,11/18/2014,AIfA-Cosmo
pcowperthwaite,0,0,0,0,0,11/19/2014,Harvard ITC
abhishd,0,0,0,0,0,11/19/2014,Clemson
marco_fake,0,0,0,0,0,11/19/2014,Clemson
Taizan Watari,0,0,0,0,0,11/20/2014,Kavli IPMU
bware,0,0,0,0,0,11/21/2014,UCSB HEP/Gravity
mhill,0,0,0,0,0,11/21/2014,Yale
mintun,0,0,0,0,0,11/21/2014,UCSB HEP/Gravity
maxbre,0,0,0,0,0,11/22/2014,INAF - Astronomical Observatory of Capodimonte
diplodocus,0,0,0,0,0,11/23/2014,Oxford University - Galaxies
szabo,0,0,0,0,0,11/24/2014,Weizmann Institute of Science
Conrad,0,0,0,0,0,11/25/2014,MoCA
Earnest0047,0,0,0,0,0,11/25/2014,UCR
Clyner791,0,0,0,0,0,11/25/2014,UFRJ
carlosvalotto,0,0,0,0,0,11/26/2014,IATE
KrystynBlock,0,0,0,0,0,11/26/2014,UIUC
mireia,0,0,0,0,0,11/27/2014,Yale
cscoccola,0,0,0,0,0,11/28/2014,IAC
ghutsi,0,0,0,0,0,12/01/2014,Tartu Obs
cputkuri,0,0,0,0,0,12/01/2014,IALP-FCAGLP
Gabriel-p,0,0,0,0,0,12/01/2014,IALP-FCAGLP
betianam,0,0,0,0,0,12/01/2014,IALP-FCAGLP
ghagele,0,0,0,0,0,12/01/2014,IALP-FCAGLP
lrizzo,0,0,0,0,0,12/02/2014,IALP-FCAGLP
lguennou,0,0,0,0,0,12/02/2014,IAS Orsay
Nico Maffione,0,0,0,0,0,12/02/2014,IALP-FCAGLP
keiko,0,0,0,0,0,12/02/2014,IALP-FCAGLP
doul,0,0,0,0,0,12/03/2014,NAOC
doulm415,0,0,0,0,0,12/03/2014,SHAO
funda.bostanci,0,0,0,0,0,12/03/2014,Istanbul University
Ada Zhou,0,0,0,0,0,12/03/2014,PKU
maurom,0,0,0,0,0,12/03/2014,IALP-FCAGLP
fwachlin,0,0,0,0,0,12/03/2014,IALP-FCAGLP
chyokoli,0,0,0,0,0,12/03/2014,University of Waterloo
bzins,0,0,0,0,0,12/03/2014,U. Pittsburgh
lydia,0,0,0,0,0,12/03/2014,IALP-FCAGLP
paulam,0,0,0,0,0,12/03/2014,IALP-FCAGLP
gblancm,0,0,0,0,0,12/03/2014,Carnegie
Alan Dressler,0,0,0,0,0,12/04/2014,Carnegie
stonnes,0,0,0,0,0,12/04/2014,Carnegie
Jorge Ariel Combi,0,0,0,0,0,12/04/2014,IALP-FCAGLP
yshen,0,0,0,0,0,12/04/2014,Carnegie
janicelee,0,0,0,0,0,12/04/2014,STScI/JHU
rachaelbeaton,0,0,0,0,0,12/04/2014,Carnegie
hhhh,0,0,0,0,0,12/05/2014,AIfA
darzouma,0,0,0,0,0,12/05/2014,IAS Orsay - ISM
ileandru,0,0,0,0,0,12/05/2014,IALP-FCAGLP
coughlan,0,0,0,0,0,12/05/2014,DIAS
serjeant,0,0,0,0,0,12/05/2014,The Open University
romina,0,0,0,0,0,12/05/2014,IALP-FCAGLP
EranOfek,0,0,0,0,0,12/08/2014,Weizmann Institute of Science
adifranz,0,0,0,0,0,12/08/2014,Fermilab
arizz,0,0,0,0,0,12/08/2014,UT Austin
PeggyGee57,0,0,0,0,0,12/09/2014,University of Southampton
ashley.spindler,0,0,0,0,0,12/09/2014,The Open University
burakkay,0,0,0,0,0,12/09/2014,Istanbul University
Ixandra,0,0,0,0,0,12/10/2014,UQ Swinburne Cosmology
Melike,0,0,0,0,0,12/10/2014,Istanbul University
mpieri,0,0,0,0,0,12/10/2014,LAM
pakmor,0,0,0,0,0,12/10/2014,HITS
RWeinberger,0,0,0,0,0,12/10/2014,HITS
robgrand,0,0,0,0,0,12/10/2014,HITS
andybauer,0,0,0,0,0,12/10/2014,HITS
Kevin_Schaal,0,0,0,0,0,12/10/2014,HITS
vspringel,0,0,0,0,0,12/10/2014,HITS
Christoph,0,0,0,0,0,12/10/2014,HITS
gvoisin,0,0,0,0,0,12/10/2014,Observatory of Paris
yanina.cochetti,0,0,0,0,0,12/11/2014,IALP-FCAGLP
joudaki,0,0,0,0,0,12/11/2014,Swinburne
eme,0,0,0,0,0,12/11/2014,Edinburgh
alessio,0,0,0,0,0,12/11/2014,DIAS
amejia,0,0,0,0,0,12/11/2014,Unaffiliated
shporer,0,0,0,0,0,12/11/2014,Caltech
MarinaS,0,0,0,0,0,12/11/2014,IALP-FCAGLP
PorfiriApplegate,0,0,0,0,0,12/13/2014,Chicago-KICP
SusanneDawes,0,0,0,0,0,12/13/2014,Chicago-KICP
TressaObrien,0,0,0,0,0,12/13/2014,Chicago-KICP
EveBurgerqtrg,0,0,0,0,0,12/13/2014,Chicago-KICP
RandallPinson,0,0,0,0,0,12/13/2014,Chicago-KICP
HildaBramlett,0,0,0,0,0,12/13/2014,Chicago-KICP
RoseannShea,0,0,0,0,0,12/13/2014,Chicago-KICP
SabinaDolling,0,0,0,0,0,12/13/2014,Chicago-KICP
AnneBrassell,0,0,0,0,0,12/13/2014,Chicago-KICP
KarryRanclaud,0,0,0,0,0,12/13/2014,Chicago-KICP
